PID,Street Address,MBLU,Map,Lot,Unit,Book&Page,Assessment,Appraisal,Lot Size (acres),Land Use Code,Description,Zoning District,# Buildings,Appr. Year,Improvements,Land,Total,Recent Sale Price,Recent Sale Date,Prev Sale Price,Prev Sale Date,Prev. Ass. Imp,Prev. Ass. Land,Prev. Ass. Tot,Prev. App. Imp,Prev. App. Land,Prev. App. Tot,,
123,30 PLEASANT ST,201/  86/  /  / ,201,86,  ,  4371/0348,284100,284100,0.69,1010,SINGLE FAM MDL01,LCD,1,2021,151900,132200,284100,295000,2018-06-29,185000,2006-03-24,120600,105500,226100,120600,105500,226100,20:05:40,1
125,24 PLEASANT ST,201/  88/  /  / ,201,88,  ,  4071/0118,427700,427700,2.3,1010,SINGLE FAM MDL01,LCD,1,2021,272000,155700,427700,365000,2014-07-21,,,227400,119300,346700,227400,119300,346700,20:05:41,2
127,16 PLEASANT ST,201/  90/  /  / ,201,90,  ,  4644/ 627,393500,393500,0.9,1010,SINGLE FAM MDL01,LCD,1,2021,240200,153300,393500,525000,2021-06-17,405000,2019-05-01,263100,114100,377200,263100,114100,377200,20:05:42,3
128,12+14 PLEASANT ST,201/  91/  /  / ,201,91,  ,  3779/0878,583500,583500,0.8,1090,MULTI HSES,LCD,2,2021,395000,188500,583500,200000,2011-03-15,125000,1997-09-09,416100,111500,527600,416100,111500,527600,20:05:43,4
129,10 PLEASANT ST,201/  92/  /  / ,201,92,  ,  4152/0371,339800,339800,1.3,1010,SINGLE FAM MDL01,LCD,1,2021,182300,157500,339800,286000,2015-08-24,225000,2006-03-07,170700,124600,295300,170700,124600,295300,20:05:44,5
132,6 JOHN THOMSON WY (L/O),201/  93/  100/  / ,201,93,100, ,40300,40300,0.16,9030,MUNICPAL  MDL-00,LDC,1,2021,0,40300,40300,0,,,,0,33700,33700,0,33700,33700,20:05:45,6
133,6 JOHN THOMSON WY(HORSESHD),201/  93/  200/  / ,201,93,200,  1005/0574,42000,42000,0,9060,CHURCH ETC  MDL-00,,1,2021,42000,0,42000,0,,,,38500,0,38500,38500,0,38500,20:05:45,7
136,2 PLEASANT ST (JAILHOUSE),201/  94/  100/  / ,201,94,100, ,27400,27400,0.07,903I,MUNICPAL  MDL-96,LCD,1,2021,15200,12200,27400,0,,,,13400,9700,23100,13400,9700,23100,20:05:46,8
137,4 JOHN THOMSON WY,201/  94/  200/  / ,201,94,200, ,236300,236300,1.85,920C,NON PROFIT  MDL-94,LCD,1,2021,46900,189400,236300,0,,,,42400,154600,197000,42400,154600,197000,20:05:47,9
139,5 DORCHESTER RD,201/  96/  /  / ,201,96,  , ,247800,247800,0.09,906C,CHURCH ETC  MDL-94,LCD,1,2021,81400,166400,247800,0,,,,73400,132400,205800,73400,132400,205800,20:05:48,10
140,7 DORCHESTER RD,201/  97/  /  / ,201,97,  ,  3890/0633,726800,726800,0.31,1010,SINGLE FAM MDL01,LCD,1,2021,575300,151500,726800,733000,2012-06-13,257000,1996-09-19,531800,156000,687800,531800,156000,687800,20:05:49,11
143,19 DORCHESTER RD,201/  100/  /  / ,201,100,  ,  4223/0595,541000,541000,1.5,1010,SINGLE FAM MDL01,LCD,1,2021,334100,206900,541000,465000,2016-07-29,222000,1993-09-02,289400,181800,471200,289400,181800,471200,20:05:50,12
144,21 DORCHESTER RD,201/  101/  /  / ,201,101,  ,  4154/0182,277800,277800,0.43,1010,SINGLE FAM MDL01,LCD,1,2021,144800,133000,277800,266700,2015-08-31,92571,1992-07-15,138000,111800,249800,138000,111800,249800,20:05:50,13
148,50 HIGH ST,201/  102/  1000/  / ,201,102,1000,  4403/0829,306500,306500,1.37,1010,SINGLE FAM MDL01,LCD,1,2021,163800,142700,306500,0,2018-11-29,122000,1994-08-24,138200,108700,246900,138200,108700,246900,20:05:51,14
149,48 HIGH ST,201/  102/  2000/  / ,201,102,2000,  4403/0829,556800,556800,1.51,3050,HOSP PVT,LCD,1,2021,385600,171200,556800,0,2018-11-29,20000,1995-08-01,290200,130100,420300,290200,130100,420300,20:05:52,15
150,44 HIGH ST (FIRE STATION),201/  103/  /  / ,201,103,  , ,580900,580900,1.28,9032,FIRE,LCD,1,2021,410700,170200,580900,0,,,,124300,129200,253500,124300,129200,253500,20:05:53,16
151,40 HIGH ST,201/  104/  /  / ,201,104,  ,  4419/0497,218500,218500,10,3900,DEVEL LAND,LCD,1,2021,0,218500,218500,200000,2019-03-04,4286,1991-05-31,0,137300,137300,0,137300,137300,20:05:54,17
153,36 HIGH ST,201/  106/  /  / ,201,106,  ,  1970/0315,260700,260700,0.66,1010,SINGLE FAM MDL01,LCD,1,2021,149400,111300,260700,115048,1992-06-01,,,138400,90300,228700,138400,90300,228700,20:05:55,18
154,32 HIGH ST,201/  107/  /  / ,201,107,  ,  3080/0109,164900,164900,0.52,1010,SINGLE FAM MDL01,LCD,1,2021,82500,82400,164900,0,2004-11-18,75000,1998-11-10,66800,72000,138800,66800,72000,138800,20:05:56,19
159,30 HIGH ST,201/  109/  1000/  / ,201,109,1000,  0841/0392,187300,187300,1.96,9010,STATE NH,LCD,1,2021,21200,166100,187300,0,1955-06-02,,,17900,127200,145100,17900,127200,145100,20:05:57,20
161,24 HIGH ST (HIGHWAY GARAGE),201/  110/  1000/  / ,201,110,1000,002888/0819,781700,781700,3.47,903I,MUNICPAL  MDL-96,LCD,1,2021,562100,219600,781700,0,2003-09-10,,,592300,158900,751200,592300,158900,751200,20:05:58,21
162,18 HIGH ST,201/  111/  /  / ,201,111,  ,  2264/0263,292200,292200,1.8,1010,SINGLE FAM MDL01,LCD,1,2021,165400,126800,292200,125000,1997-08-05,,,165400,97100,262500,165400,97100,262500,20:05:59,22
163,14 HIGH ST,201/  112/  /  / ,201,112,  ,  2258/0725,428500,428500,0.76,1090,MULTI HSES,LCD,2,2021,269600,158900,428500,111000,1997-06-27,4000,1988-01-22,298800,97300,396100,298800,97300,396100,20:05:59,23
164,8 HIGH ST,201/  113/  /  / ,201,113,  ,  3957/0001,144500,144500,0.58,1010,SINGLE FAM MDL01,LCD,1,2021,46200,98300,144500,0,2013-02-20,100000,2007-04-06,38900,83100,122000,38900,83100,122000,20:06:00,24
167,4 CREAMERY LN,201/  117/  /  / ,201,117,  ,  2249/0467,513300,513300,1.53,101,Single Fam,LCD,2,2021,289300,224000,513300,0,1996-12-02,138500,1995-09-22,279800,110300,390100,279800,110300,390100,20:06:01,25
168,13 CREAMERY LN,201/  118/  /  / ,201,118,  ,  4111/0827,304100,304100,1.5,1010,SINGLE FAM MDL01,LCD,1,2021,174500,129600,304100,0,2015-02-23,4000,1988-03-23,146700,98800,245500,146700,98800,245500,20:06:02,26
170,1 HIGH ST,201/  120/  /  / ,201,120,  ,  3546/0936,1492300,1492300,3.11,903R,MUNICIPAL MDL-01,LCD,2,2021,1225500,266800,1492300,0,2008-09-02,,,1095300,204200,1299500,1095300,204200,1299500,20:06:03,27
172,10 SPRING HILL LN,201/  123/  /  / ,201,123,  ,  2253/ 229,300,161400,7.68,6335,OTUNR-5,LCD,1,2021,0,161400,161400,835000,1997-05-30,10000,1997-01-31,0,300,300,0,119400,119400,20:06:04,28
173,6 SPRING HILL LN,201/  124/  /  / ,201,124,  ,  3408/0510,619200,619200,1.5,1010,SINGLE FAM MDL01,,1,2021,465200,154000,619200,500000,2007-05-18,390000,2003-07-31,361400,117800,479200,361400,117800,479200,20:06:05,29
174,13 HIGH ST,201/  125/  /  / ,201,125,  ,  3993/0932,284500,284500,1.56,1010,SINGLE FAM MDL01,LCD,1,2021,152300,132200,284500,255000,2013-07-09,,,136900,100500,237400,136900,100500,237400,20:06:06,30
176,15 HIGH ST,201/  126/  /  / ,201,126,  ,  1413/0147,294500,294500,1.66,1010,SINGLE FAM MDL01,LCD,1,2021,156600,137900,294500,4000,1980-12-23,,,116500,105000,221500,116500,105000,221500,20:06:06,31
100021,288 ORFORD RD,406/  22/  2000/  / ,406,22,2000,  4349/0226,1359700,1649100,158.82,1010,SINGLE FAM MDL01,RD,1,2021,1128800,520300,1649100,0,2018-03-21,1200000,2016-11-01,1046600,280100,1326700,1046600,542000,1588600,20:06:07,32
177,19 HIGH ST,201/  127/  /  / ,201,127,  ,  4181/ 634,214900,214900,1.3,1010,SINGLE FAM MDL01,LCD,1,2021,85100,129800,214900,175000,2016-01-05,,,92300,88300,180600,92300,88300,180600,20:06:08,33
178,27 HIGH ST,201/  128/  1000/  / ,201,128,1000,  2197/0241,358400,358400,2.17,1010,SINGLE FAM MDL01,LCD,1,2021,231800,126600,358400,165000,1996-05-17,85000,1989-03-31,205300,97000,302300,205300,97000,302300,20:06:09,34
179,35 HIGH ST,201/  129/  /  / ,201,129,  ,4130-0104,287500,287500,1.7,1010,SINGLE FAM MDL01,LCD,1,2021,149400,138100,287500,249000,2015-05-26,240000,2004-11-22,140700,105200,245900,140700,105200,245900,20:06:10,35
181,31 ROCKY HILL LN,201/  131/  /  / ,201,131,  ,  2804/0476,2500,333600,20,1320,RES ACLNUD,LCD,1,2021,0,333600,333600,0,2003-04-16,66000,1987-12-14,0,2400,2400,0,246600,246600,20:06:11,36
182,12 ROCKY HILL LN,201/  132/  /  / ,201,132,  ,  1682/0690,686100,741100,12.8,1010,SINGLE FAM MDL01,LCD,1,2021,507900,233200,741100,30000,1987-07-17,,,520800,227800,748600,520800,267400,788200,20:06:11,37
183,49 HIGH ST,201/  133/  /  / ,201,133,  ,  4581/ 400,113900,113900,0.95,1060,AC LND IMP,LCD,1,2021,10900,103000,113900,100000,2020-12-03,25000,2015-11-23,12500,67000,79500,12500,67000,79500,20:06:12,38
249,13 HEWS LN,401/  46/  /  / ,401,46,  ,  1988/0756,300200,300200,2.8,1010,SINGLE FAM MDL01,RD,1,2021,155900,144300,300200,0,1992-09-15,15000,1988-09-22,167400,122000,289400,167400,122000,289400,20:06:13,39
189,76 GOODELL LN,401/  4/  /  / ,401,4,  ,  3136/0533,53300,138100,37,1060,AC LND IMP,RD,1,2021,8500,129600,138100,0,2005-05-05,,,7800,35200,43000,7800,111900,119700,20:06:14,40
190,54 GOODELL LN,401/  5/  /  / ,401,5,  ,  1783/0218,1000,59200,23.11,6215,HWMR-5,RD,1,2021,0,59200,59200,4000,1988-12-27,,,0,1000,1000,0,52800,52800,20:06:15,41
191,42 GOODELL LN,401/  6/  /  / ,401,6,  ,002771/0009,6000,204100,104.74,6514,FARMR-4,RD,1,2021,0,204100,204100,0,2002-11-05,,,0,6000,6000,0,184700,184700,20:06:16,42
192,68 PRESTON RD,401/  7/  /  / ,401,7,  ,  1097/0311,25500,689600,191.4,6125,WPUN-5,RD,1,2021,0,689600,689600,0,1990-05-01,,,0,25500,25500,0,576600,576600,20:06:17,43
195,298 BAKER HILL RD,401/  10/  /  / ,401,10,  ,  3547/0074,519700,519700,5.2,1010,SINGLE FAM MDL01,RD,1,2021,343500,176200,519700,475000,2008-09-03,320000,2006-09-18,328100,138000,466100,328100,138000,466100,20:06:18,44
197,65 GOODELL LN,401/  12/  /  / ,401,12,  ,  1783/0218,2500,166600,81.63,6213,HWMR-3,RD,1,2021,0,166600,166600,0,,,,0,2500,2500,0,154300,154300,20:06:19,45
203,102 DARTMOUTH COLLEGE HY,401/  14/  /  / ,401,14,  ,  4551/ 229,357500,357500,0.83,1010,SINGLE FAM MDL01,RD,1,2021,232400,125100,357500,303000,2020-08-31,314000,2019-12-16,195200,93600,288800,195200,93600,288800,20:06:19,46
204,84 DARTMOUTH COLLEGE HY,401/  15/  /  / ,401,15,  ,  3128/0001,720800,880700,52,1120,APT OVER 8,BD,1,2021,396000,484700,880700,0,2005-04-14,110700,1977-08-30,256600,173200,429800,256600,318000,574600,20:06:20,47
206,60 DARTMOUTH COLLEGE HY,401/  17/  /  / ,401,17,  ,  4221/0423,742600,834600,15.8,1010,SINGLE FAM MDL01,RD,1,2021,606800,227800,834600,185000,2016-07-19,19500,2011-08-17,566800,103200,670000,566800,186800,753600,20:06:21,48
207,19 GOOSE POND RD,401/  18/  /  / ,401,18,  ,  4011/0594,54400,649200,125.6,1060,AC LND IMP,RD,1,2021,1700,647500,649200,0,2013-09-16,,,1500,52700,54200,1500,578300,579800,20:06:22,49
209,51 GOOSE POND RD,401/  20/  /  / ,401,20,  ,  3856/0585,262300,262300,1.5,1010,SINGLE FAM MDL01,RD,1,2021,119000,143300,262300,0,2012-02-07,210000,2007-03-06,102800,99100,201900,102800,99100,201900,20:06:23,50
210,57 GOOSE POND RD,401/  21/  /  / ,401,21,  ,  4254/0892,337100,337100,1.5,1010,SINGLE FAM MDL01,RD,1,2021,193800,143300,337100,0,2016-12-14,,,186600,99100,285700,186600,99100,285700,20:06:24,51
100361,137 MUD TURTLE POND RD,406/  26/  /  / ,406,26,  ,  3107/0182,4200,83150,95,6204,HWM-4,RD,1,2021,0,83150,83150,0,2005-02-11,,,0,4200,4200,0,83150,83150,20:06:25,52
217,127 GOOSE POND RD,401/  23/  1100/  / ,401,23,1100,  4519/ 345,2600,476800,56.37,6234,HWUNR-4,RD,1,2021,0,476800,476800,496533,2020-05-14,310000,1989-08-13,0,2600,2600,0,259100,259100,20:06:26,53
219,149 GOOSE POND RD,401/  23/  3000/  / ,401,23,3000,  4049/0602,340600,340600,2.82,1010,SINGLE FAM MDL01,RD,1,2021,176100,164500,340600,290000,2014-04-11,320533,2005-08-31,189400,99100,288500,189400,99100,288500,20:06:27,54
220,153 GOOSE POND RD,401/  24/  /  / ,401,24,  ,  4144/0841,288500,288500,2,1010,SINGLE FAM MDL01,RD,1,2021,180400,108100,288500,0,2015-07-08,,,140700,82700,223400,140700,82700,223400,20:06:27,55
221,157 GOOSE POND RD,401/  25/  /  / ,401,25,  ,  3216/0807,317500,317500,1.7,1010,SINGLE FAM MDL01,RD,1,2021,221900,95600,317500,267000,2005-11-07,65500,1995-06-05,173600,73500,247100,173600,73500,247100,20:06:28,56
223,32 PELTON LN,401/  27/  /  / ,401,27,  ,  3398/0435,448800,498200,11.67,1040,TWO FAMILY,RD,1,2021,322900,175300,498200,175000,2007-04-20,4000,1998-06-09,288000,113500,401500,288000,157200,445200,20:06:29,57
225,342 BAKER HILL RD,401/  29/  /  / ,401,29,  ,  4642/ 600,262700,262700,6.1,1030,MOBILE HOM  MDL-02,RD,2,2021,86100,176600,262700,0,2021-06-22,,,73100,113900,187000,73100,113900,187000,20:06:30,58
229,320 BAKER HILL RD,401/  30/  1000/  / ,401,30,1000,  4086/ 693,492300,492300,2.6,1010,SINGLE FAM MDL01,RD,1,2021,312700,179600,492300,400000,2014-10-03,376000,2011-07-08,290000,105400,395400,290000,105400,395400,20:06:31,59
230,330 BAKER HILL RD,401/  30/  2000/  / ,401,30,2000,  3943/0927,2800,218200,29.4,6335,OTUNR-5,RD,1,2021,0,218200,218200,0,2012-12-28,,,0,2800,2800,0,175200,175200,20:06:33,60
232,156 GOOSE POND RD,401/  32/  /  / ,401,32,  ,  4153/0352,130000,130000,0.45,1010,SINGLE FAM MDL01,RD,1,2021,72200,57800,130000,146000,2015-08-26,45000,2010-07-01,54200,52500,106700,54200,52500,106700,20:06:34,61
233,154 GOOSE POND RD,401/  33/  /  / ,401,33,  ,  1254/0406,146600,146600,0.45,1010,SINGLE FAM MDL01,RD,1,2021,81500,65100,146600,0,,,,59900,59000,118900,59900,59000,118900,20:06:35,62
235,144 GOOSE POND RD,401/  35/  /  / ,401,35,  ,  4200/0326,625200,625200,6.2,1010,SINGLE FAM MDL01,,2,2021,455900,169300,625200,535000,2016-04-20,163048,1990-08-10,403100,107900,511000,403100,107900,511000,20:06:36,63
236,142 GOOSE POND RD,401/  36/  /  / ,401,36,  ,  3084/0708,304100,304100,0.91,1010,SINGLE FAM MDL01,RD,1,2021,184400,119700,304100,0,2004-12-01,96000,1990-12-24,152400,67800,220200,152400,67800,220200,20:06:37,64
100041,198 BAKER HILL RD,410/  9/  2000/  / ,410,9,2000,  4040/ 020,8800,338400,37.35,6506,FARM-6,RD,1,2021,0,338400,338400,0,2014-02-10,112942,1989-11-03,0,8800,8800,0,286400,286400,20:06:38,65
237,138 GOOSE POND RD,401/  37/  /  / ,401,37,  ,002864/0255,133300,133300,0.47,1030,MOBILE HOM  MDL-02,RD,1,2021,45100,88200,133300,74933,2003-08-01,17000,1979-05-25,39500,53000,92500,39500,53000,92500,20:06:39,66
241,72 GOOSE POND RD,401/  39/  /  / ,401,39,  ,  4013/0532,307200,863300,174,1010,SINGLE FAM MDL01,RD,1,2021,143900,719400,863300,750000,2013-09-24,,,120900,116900,237800,120900,621400,742300,20:06:40,67
244,40 GOOSE POND RD,401/  41/  /  / ,401,41,  ,   334/0303,800,800,0.07,1320,RES ACLNUD,,1,2021,0,800,800,0,2006-10-08,,,0,700,700,0,700,700,20:06:40,68
245,36 GOOSE POND RD,401/  42/  /  / ,401,42,  ,  4468/0924,308900,308900,0.54,1010,SINGLE FAM MDL01,RD,1,2021,193200,115700,308900,355000,2019-09-27,179000,2017-05-15,98100,86300,184400,98100,86300,184400,20:06:41,69
246,20 DARTMOUTH COLLEGE HY,401/  43/  /  / ,401,43,  , ,6200,300300,32.8,6515,FARMR-5,RD,1,2021,0,300300,300300,0,2002-02-18,2666,2001-04-27,0,6200,6200,0,253600,253600,20:06:42,70
247,1 DARTMOUTH COLLEGE HY,401/  44/  /  / ,401,44,  ,  1480/0578,162600,162600,1.1,1090,MULTI HSES,RD,2,2021,13400,149200,162600,0,,,,10400,92900,103300,10400,92900,103300,20:06:43,71
248,7 HEWS LN,401/  45/  /  / ,401,45,  ,  0971/0381,264000,264000,2.4,1010,SINGLE FAM MDL01,RD,1,2021,126300,137700,264000,0,,,,144000,105500,249500,144000,105500,249500,20:06:44,72
1,FLOWAGE RIGHTS,100/  1/  /  / ,100,1,  ,   001/ 001,1254000,1254000,0,422,ELEC PLANT,,1,2021,1254000,0,1254000,0,2017-04-20,26278600,2005-03-31,1254000,0,1254000,1254000,0,1254000,20:06:45,73
2,POWER LINES/L-37.62 MI,100/  2/  /  / ,100,2,  , ,2861300,2861300,0,422,ELEC PLANT,,1,2021,2861300,0,2861300,0,,,,2695800,0,2695800,2695800,0,2695800,20:06:47,74
3,POWER LINES,100/  3/  /  / ,100,3,  ,002944/0182,2527700,2527700,0,422,ELEC PLANT,,1,2021,2527700,0,2527700,1019533,2004-01-01,,,2527700,0,2527700,2527700,0,2527700,20:06:47,75
4,POWER LINES,100/  4/  /  / ,100,4,  , ,500,500,0,422,ELEC PLANT,,1,2021,500,0,500,0,,,,500,0,500,500,0,500,20:06:48,76
5,58 DORCHESTER RD,201/  1/  /  / ,201,1,  ,  4243/0312,261300,261300,3.9,1010,SINGLE FAM MDL01,LCD,1,2021,93700,167600,261300,0,2016-10-25,150000,2012-01-03,80700,130200,210900,80700,130200,210900,20:06:49,77
7,42 DORCHESTER RD,201/  4/  /  / ,201,4,  ,002833/0693,181800,181800,0.49,1010,SINGLE FAM MDL01,LCD,1,2021,77200,104600,181800,0,2002-12-16,,,62000,88200,150200,62000,88200,150200,20:06:50,78
8,40 DORCHESTER RD,201/  5/  /  / ,201,5,  ,002833/0693,254400,254400,0.98,1010,SINGLE FAM MDL01,LCD,1,2021,114000,140400,254400,0,2002-12-16,,,106600,101200,207800,106600,101200,207800,20:06:51,79
9,36 DORCHESTER RD,201/  6/  /  / ,201,6,  ,  3303/0204,266800,266800,1.85,1010,SINGLE FAM MDL01,LCD,1,2021,108900,157900,266800,5000,2006-07-12,,,89500,121300,210800,89500,121300,210800,20:06:52,80
10,32 DORCHESTER RD,201/  7/  /  / ,201,7,  ,  3307/0544,417100,417100,2.46,1010,SINGLE FAM MDL01,LCD,1,2021,254100,163000,417100,240000,2006-05-31,5000,1953-08-07,254100,125900,380000,254100,125900,380000,20:06:53,81
12,22 DORCHESTER RD,201/  9/  /  / ,201,9,  ,  4243/0537,487000,487000,3.11,1010,SINGLE FAM MDL01,LCD,1,2021,261800,225200,487000,500000,2016-10-24,14000,2008-07-28,260800,171900,432700,260800,171900,432700,20:06:54,82
13,18 DORCHESTER RD,201/  10/  /  / ,201,10,  ,  1812/0014,556400,556400,1.6,1010,SINGLE FAM MDL01,LCD,2,2021,275700,280700,556400,121000,1989-07-06,,,257200,186800,444000,257200,186800,444000,20:06:54,83
16,1 MARKET ST,201/  11/  /  / ,201,11,  ,  4094/0467,1401800,1401800,1.4,3020,INNS,LCD,1,2021,1016100,385700,1401800,950000,2014-11-12,500000,2008-09-02,913900,292700,1206600,913900,292700,1206600,20:06:56,84
18,7 MARKET ST,201/  12/  1000/  / ,201,12,1000,  4538/ 917,301600,301600,0.37,1010,SINGLE FAM MDL01,LCD,1,2021,162500,139100,301600,435000,2020-07-23,97000,1988-10-07,161500,138400,299900,161500,138400,299900,20:06:57,85
19,5 MARKET ST,201/  12/  2000/  / ,201,12,2000,  4538/ 917,154000,154000,0.05,1010,SINGLE FAM MDL01,LCD,1,2021,91700,62300,154000,435000,2020-07-23,97000,1988-10-07,82100,53500,135600,82100,53500,135600,20:06:58,86
20,11 MARKET ST,201/  13/  /  / ,201,13,  ,  3651/0625,615800,615800,1.6,1010,SINGLE FAM MDL01,LCD,1,2021,381400,234400,615800,0,2009-09-30,92000,1986-06-12,367500,206400,573900,367500,206400,573900,20:06:59,87
21,15 MARKET ST,201/  14/  /  / ,201,14,  ,  4414/0628,686500,686500,1.8,1090,MULTI HSES,LCD,2,2021,398100,288400,686500,0,2019-02-01,550000,2018-07-09,409800,203600,613400,409800,203600,613400,20:07:00,88
22,19 MARKET ST,201/  15/  /  / ,201,15,  ,  3902/0145,449000,449000,0.55,1010,SINGLE FAM MDL01,LCD,1,2021,269300,179700,449000,0,2012-07-25,362000,2012-07-03,211300,178700,390000,211300,178700,390000,20:07:01,89
23,25 MARKET ST,201/  16/  /  / ,201,16,  ,  1217/0589,478700,478700,4.31,101,Single Fam,LCD,1,2021,233100,245600,478700,42400,1974-04-11,,,227500,214300,441800,227500,214300,441800,20:07:01,90
26,26 MARKET ST,201/  19/  /  / ,201,19,  ,  4136/0106,356400,356400,1.1,1010,SINGLE FAM MDL01,LCD,1,2021,151100,205300,356400,195000,2015-06-17,98000,1990-06-22,143500,150400,293900,143500,150400,293900,20:07:03,91
25,30 MARKET ST,201/  18/  /  / ,201,18,  ,  2510/0517,581100,581100,0.5,1010,SINGLE FAM MDL01,RD,1,2021,410600,170500,581100,290000,2000-12-14,30000,1983-05-17,319400,149000,468400,319400,149000,468400,20:07:04,92
28,20 MARKET ST,201/  21/  /  / ,201,21,  ,  3967/ 527,536900,536900,3.5,1010,SINGLE FAM MDL01,LCD,1,2021,292900,244000,536900,0,2013-04-02,4000,1998-04-10,284900,215400,500300,284900,215400,500300,20:07:05,93
101602,27 PLEASANT ST,201/  80/  0020/  / ,201,80,20,  3664/0671,243200,243200,0,1020,CONDO,LCD,1,2021,243200,0,243200,140000,2009-11-19,65000,1999-08-04,217800,0,217800,217800,0,217800,20:07:06,94
101622,3 PRESTON RD,402/  37/  0100/  / ,402,37,100,  4306/0960,448700,508900,12.52,1010,SINGLE FAM MDL01,RD,1,2021,334300,174600,508900,110000,2017-08-25,125000,2006-03-13,139800,96100,235900,139800,150500,290300,20:07:07,95
101642,11  PRESTON RD,401/  1/  1000/  / ,401,1,1000,  2923/0335,426700,426700,3.01,1010,SINGLE FAM MDL01,RD,1,2021,281900,144800,426700,196000,2003-11-13,,,260900,111600,372500,260900,111600,372500,20:07:08,96
32,8 MARKET ST,201/  25/  /  / ,201,25,  ,  3072/0304,277800,277800,0.37,1010,SINGLE FAM MDL01,LCD,1,2021,131000,146800,277800,248000,2004-10-29,7000,1957-07-05,119100,154700,273800,119100,154700,273800,20:07:08,97
570,655 RIVER RD,405/  30/  2000/  / ,405,30,2000,  2142/0379,528000,762400,27.54,1013,SFR WATER  MDL-01,RD,3,2021,184400,578000,762400,175000,1995-05-19,220000,1994-07-20,138500,281900,420400,138500,487100,625600,20:07:09,98
571,667 RIVER RD,405/  31/  /  / ,405,31,  ,  4601/ 158,349100,349100,3,1010,SINGLE FAM MDL01,RD,1,2021,169100,180000,349100,260000,2021-02-08,,,120400,158500,278900,120400,158500,278900,20:07:10,99
572,669 RIVER RD,405/  32/  /  / ,405,32,  ,  4635/ 378,364900,364900,0.93,1010,SINGLE FAM MDL01,RD,1,2021,181000,183900,364900,288800,2021-05-28,48000,2020-03-18,31500,117100,148600,31500,117100,148600,20:07:11,100
883,108 HORTON LN,408/  45/  /  / ,408,45,  ,  1370/0997,73000,164900,50.1,1010,SINGLE FAM MDL01,RD,1,2021,21300,143600,164900,0,1979-07-20,,,31000,37900,68900,31000,164600,195600,20:07:12,101
884,44 HORTON LN,408/  46/  /  / ,408,46,  ,  1479/0812,352500,426500,20,1010,SINGLE FAM MDL01,RD,1,2021,191000,235500,426500,18000,1983-08-12,36000,1977-09-09,169000,142300,311300,169000,209500,378500,20:07:13,102
100401,65 WASHBURN HILL RD,402/  15/  2000/  / ,402,15,2000,  0000/0000,2500,315200,37.66,6114,WPMR-4,RD,1,2021,0,315200,315200,0,2005-05-20,,,0,2500,2500,0,263300,263300,20:07:14,103
887,36 HORTON LN,408/  47/  1000/  / ,408,47,1000,  4027/0777,1360300,1472800,30.1,1010,SINGLE FAM MDL01,RD,1,2021,998100,474700,1472800,1490000,2013-11-26,285000,1995-09-18,950800,398700,1349500,950800,500700,1451500,20:07:15,104
578,765 RIVER RD,405/  38/  1000/  / ,405,38,1000,  3816/0072,1768800,1917400,12.58,1013,SFR WATER  MDL-01,RD,1,2021,881300,1036100,1917400,0,2011-08-25,,,931500,539800,1471300,931500,654800,1586300,20:07:15,105
579,772 RIVER RD,405/  39/  /  / ,405,39,  ,  3480/0184,655300,710500,10,1010,SINGLE FAM MDL01,RD,1,2021,443300,267200,710500,0,2007-12-20,,,360800,234300,595100,360800,284400,645200,20:07:16,106
580,748 RIVER RD,405/  40/  /  / ,405,40,  ,  1792/0815,19300,19300,7,1300,RES ACLNDV,RD,1,2021,0,19300,19300,0,1989-02-15,,,0,17500,17500,0,17500,17500,20:07:17,107
581,736 RIVER RD,405/  42/  1000/  / ,405,42,1000,  4474/ 623,415500,737000,49.5,1060,AC LND IMP,RD,1,2021,169200,567800,737000,0,2019-10-17,525000,1998-03-17,153400,246300,399700,153400,521200,674600,20:07:18,108
582,738 RIVER RD,405/  42/  2000/  / ,405,42,2000,  4474/0623,1378800,1643300,65,1010,SINGLE FAM MDL01,RD,1,2021,971900,671400,1643300,1525000,2019-10-17,525000,1998-03-17,519000,278800,797800,519000,518200,1037200,20:07:19,109
584,122 BRECK HILL RD,405/  44/  /  / ,405,44,  ,  4103/0394,789100,1093000,61.66,1010,SINGLE FAM MDL01,RD,1,2021,561900,531100,1093000,758000,2014-12-29,565000,1995-09-20,454200,275500,729700,454200,550800,1005000,20:07:20,110
591,100 BRECK HILL RD,405/  45/  1000/  / ,405,45,1000,  1994/0666,11200,346300,21.15,1300,RES ACLNDV,RD,1,2021,0,346300,346300,0,1994-12-19,,,0,11200,11200,0,258900,258900,20:07:21,111
592,92 BRECK HILL RD,405/  45/  2000/  / ,405,45,2000,  1994/0666,1000,190200,5.35,6126,WPUN-6,RD,1,2021,0,190200,190200,0,1994-12-19,,,0,1000,1000,0,144900,144900,20:07:22,112
593,80 BRECK HILL RD,405/  46/  /  / ,405,46,  ,  4366/0205,525600,606800,25,1010,SINGLE FAM MDL01,RD,1,2021,234800,372000,606800,250000,2016-06-08,2666,2002-07-12,155100,257100,412200,155100,330600,485700,20:07:23,113
34,4 MARKET ST,201/  27/  /  / ,201,27,  ,  4368/0297,552900,552900,0.4,1010,SINGLE FAM MDL01,LCD,1,2021,395200,157700,552900,0,2018-06-19,135000,1988-02-01,391300,166100,557400,391300,166100,557400,20:07:23,114
35,1 ON THE COMMON (COMMON),201/  28/  /  / ,201,28,  , ,29200,29200,1.4,9035,TOWN-PROP,LCD,1,2021,0,29200,29200,0,,,,0,24000,24000,0,24000,24000,20:07:24,115
37,16 ON THE COMMON,201/  30/  /  / ,201,30,  ,  4325/0395,650500,650500,0.78,920C,NON PROFIT  MDL-94,LCD,1,2021,297500,353000,650500,425000,2017-11-15,447000,2009-02-04,199500,286400,485900,199500,286400,485900,20:07:25,116
103137,16  ON THE COMMON,201/  30/  T/  / ,201,30,  T,  4325/0395,50000,50000,0,3900,DEVEL LAND,,1,2021,50000,0,50000,425000,2017-11-15,,,45500,0,45500,45500,0,45500,20:07:26,117
39,14 ON THE COMMON,201/  31/  1000/  / ,201,31,1000,  4554/ 777,576700,576700,3.08,1040,TWO FAMILY,LCD,1,2021,339700,237000,576700,640000,2020-09-15,440000,2005-05-20,421400,208700,630100,421400,208700,630100,20:07:27,118
40,18 MARKET ST (BIG ROCK),201/  31/  2000/  / ,201,31,2000,  2295/0028,43000,43000,9.99,9035,TOWN-PROP,,1,2021,0,43000,43000,0,1997-11-18,,,0,37300,37300,0,37300,37300,20:07:27,119
41,12 ON THE COMMON,201/  32/  /  / ,201,32,  ,  3087/0441,633000,633000,0.65,1010,SINGLE FAM MDL01,LCD,1,2021,447000,186000,633000,625000,2004-12-14,129000,1998-10-29,441600,175800,617400,441600,175800,617400,20:07:28,120
42,10 ON THE COMMON,201/  33/  /  / ,201,33,  ,  3371/0737,488500,488500,1.5,1010,SINGLE FAM MDL01,LCD,1,2021,269800,218700,488500,0,2006-12-07,,,246800,192400,439200,246800,192400,439200,20:07:29,121
43,8 ON THE COMMON,201/  34/  /  / ,201,34,  ,  4183/ 405,345600,345600,1.71,1010,SINGLE FAM MDL01,LCD,1,2021,137300,208300,345600,0,2016-01-13,195000,2004-07-07,156300,163100,319400,156300,163100,319400,20:07:30,122
50,6 ON THE COMMON UNIT #1,201/  35/  0010/  / ,201,35,10,  2364/0058,194300,194300,0,1021,CONDO NL  MDL-05,LCD,1,2021,194300,0,194300,102000,1998-12-21,100000,1994-11-10,150100,0,150100,150100,0,150100,20:07:31,123
54,6 ON THE COMMON UNIT #5,201/  35/  0050/  / ,201,35,50,  4125/0135,179900,179900,0,1021,CONDO NL  MDL-05,LCD,1,2021,179900,0,179900,142000,2015-05-04,149000,2002-12-27,137400,0,137400,137400,0,137400,20:07:32,124
1136,182 GOOSE POND RD,410/  73/  /  / ,410,73,  ,  3003/0844,175000,175000,1.2,1030,MOBILE HOM  MDL-02,RD,1,2021,82700,92300,175000,159000,2004-05-28,129000,2002-09-20,68400,70500,138900,68400,70500,138900,20:07:32,125
1126,203 GOOSE POND RD,410/  63/  /  / ,410,63,  ,  3902/0658,297900,297900,2.1,1040,TWO FAMILY,RD,1,2021,194300,103600,297900,0,2012-07-27,255000,2005-07-01,168200,79300,247500,168200,79300,247500,20:07:34,126
56,4 ON THE COMMON,201/  36/  /  / ,201,36,  ,  3516/0484,1160900,1160900,0.18,3160,COMM WHSE,LCD,1,2021,926400,234500,1160900,0,2008-04-22,7543800,2008-04-02,908500,186700,1095200,908500,186700,1095200,20:07:35,127
1165,101 GRAFTON TK,413/  1/  /  / ,413,1,  ,  2525/0702,155600,155600,0.24,1010,SINGLE FAM MDL01,ELD,1,2021,70500,85100,155600,80000,2001-03-29,,,57300,71800,129100,57300,71800,129100,20:07:36,128
58,38 UNION ST (LIBRARY),201/  38/  /  / ,201,38,  , ,915600,915600,0.44,903C,MUNICPAL  MDL-94,LCD,1,2021,653600,262000,915600,0,,,,604000,255500,859500,604000,255500,859500,20:07:37,129
575,711 RIVER RD,405/  35/  /  / ,405,35,  ,  4561/ 481,1746300,1993400,21.5,1013,SFR WATER  MDL-01,RD,3,2021,862000,1131400,1993400,1950000,2020-10-05,1519000,2016-06-06,731800,537400,1269200,731800,765900,1497700,20:07:38,130
576,729 RIVER RD,405/  36/  /  / ,405,36,  ,  3928/0824,3433400,3433400,18.43,1013,SFR WATER  MDL-01,,5,2021,2084100,1349300,3433400,0,2012-11-01,,,1802900,943100,2746000,1802900,943100,2746000,20:07:39,131
250,17 HEWS LN,401/  47/  /  / ,401,47,  ,  4117/0767,2700,341700,21,6513,FARMR-3,RD,1,2021,0,341700,341700,0,2015-03-30,1100000,2006-11-17,0,2700,2700,0,280000,280000,20:07:40,132
251,20 HEWS LN,401/  48/  /  / ,401,48,  ,  4424/0051,599200,716100,19.03,1010,SINGLE FAM MDL01,RD,1,2021,367000,349100,716100,400000,2019-03-29,2666,2001-10-18,163700,182600,346300,163700,287200,450900,20:07:40,133
252,10 HEWS LN,401/  49/  /  / ,401,49,  ,  1667/0399,321000,428200,28.65,1010,SINGLE FAM MDL01,RD,1,2021,176700,251500,428200,20000,1987-05-18,,,155600,94600,250200,155600,191800,347400,20:07:41,134
253,8 HEWS LN,401/  50/  /  / ,401,50,  ,  3420/0886,362500,362500,2.4,1010,SINGLE FAM MDL01,RD,1,2021,212100,150400,362500,0,2007-06-19,,,187200,116400,303600,187200,116400,303600,20:07:42,135
254,43 DARTMOUTH COLLEGE HY,401/  51/  /  / ,401,51,  ,  4388/0289,507600,817700,53.9,1010,SINGLE FAM MDL01,RD,1,2021,356800,460900,817700,0,2018-09-13,,,243100,117600,360700,243100,398600,641700,20:07:43,136
255,61 DARTMOUTH COLLEGE HY,401/  52/  /  / ,401,52,  ,002760/0503,564800,564800,2.2,1010,SINGLE FAM MDL01,RD,1,2021,435400,129400,564800,232266,2002-12-20,,,188200,99500,287700,188200,99500,287700,20:07:44,137
256,63-69 DARTMOUTH COLLEGE HY,401/  53/  1000/  / ,401,53,1000,  4013/ 0518,1732200,1732200,3.2,101,Single Fam,RD,4,2021,1367900,364300,1732200,116733,2013-09-23,,,1251500,237700,1489200,1251500,237700,1489200,20:07:45,138
257,77 DARTMOUTH COLLEGE HY,401/  54/  /  / ,401,54,  ,  4223/0643,187600,187600,2.4,1010,SINGLE FAM MDL01,RD,1,2021,56900,130700,187600,150000,2016-08-01,,,67900,100700,168600,67900,100700,168600,20:07:46,139
258,85 DARTMOUTH COLLEGE HY #3010,401/  55/  301/  / ,401,55,301,  3324/0514,378800,378800,0,1021,CONDO NL  MDL-05,BD,1,2021,378800,0,378800,368533,2006-08-30,167266,2003-03-05,347600,0,347600,347600,0,347600,20:07:47,140
259,101 DARTMOUTH COLLEGE HY,401/  56/  /  / ,401,56,  ,  2297/0890,3047400,3047400,136,904C,PRI SCHOOL  MDL-94,,1,2021,2454700,592700,3047400,250000,1998-02-17,252000,1993-09-21,2190400,492700,2683100,2190400,492700,2683100,20:07:48,141
260,82 RIVER RD,401/  57/  /  / ,401,57,  ,  4329/0380,247100,247100,0.83,1010,SINGLE FAM MDL01,RD,1,2021,82600,164500,247100,0,2017-12-04,1500,1970-02-12,61100,157300,218400,61100,157300,218400,20:07:49,142
102876,66 BLISS LN,410/  46/  2000/  / ,410,46,2000,  4648/  22,800,327900,22.45,6334,OTUNR-4,RD,1,2021,0,327900,327900,0,2021-01-29,1695000,2014-03-27,0,800,800,0,281700,281700,20:07:50,143
267,7 WILMOTT WY,401/  59/  /  / ,401,59,  ,  1150/0068,189500,189500,5.78,1030,MOBILE HOM  MDL-02,RD,1,2021,66900,122600,189500,0,,,,36300,96600,132900,36300,96600,132900,20:07:51,144
270,21 WILMOTT WY,401/  60/  /  / ,401,60,  ,  1829/0728,172200,172200,4.91,1030,MOBILE HOM  MDL-02,RD,1,2021,54400,117800,172200,40000,1989-10-24,,,33700,92300,126000,33700,92300,126000,20:07:52,145
271,25 WILMOTT WY,401/  61/  /  / ,401,61,  ,  2270/0888,421400,421400,2.1,1090,MULTI HSES,RD,2,2021,293800,127600,421400,73000,1997-09-06,40000,1989-10-16,313300,78200,391500,313300,78200,391500,20:07:53,146
273,34 WILMOTT WY,401/  63/  /  / ,401,63,  ,PRO-1988,133500,133500,2.01,1030,MOBILE HOM  MDL-02,RD,1,2021,32800,100700,133500,0,1988-01-01,,,25700,69300,95000,25700,69300,95000,20:07:55,147
275,12 WILMOTT WY,401/  65/  /  / ,401,65,  ,  1851/ 914,140000,140000,2.5,1030,MOBILE HOM  MDL-02,RD,1,2021,30200,109800,140000,79900,1990-03-19,,,14200,84200,98400,14200,84200,98400,20:07:56,148
102896,59 ORFORD RD,408/  19/  /  / ,408,19,  ,  4658/ 326,500,206700,6.2,6224,HWUN-4,RD,1,2021,0,206700,206700,219000,2021-08-12,,,0,400,400,0,69900,69900,20:07:57,149
102770,100 RIVER RD,402/  85/  /  / ,402,85,  ,  4102/0216,813200,988800,38.81,1010,SINGLE FAM MDL01,RD,1,2021,632600,356200,988800,550000,2014-12-19,,,572100,196400,768500,572100,355700,927800,20:07:58,150
102771,355 ORFORD RD,406/  5/  /  / ,406,5,  ,  4315/0624,292200,292200,1.4,1010,SINGLE FAM MDL01,,1,2021,155400,136800,292200,250000,2017-10-03,130000,2016-11-22,142000,93900,235900,142000,93900,235900,20:07:59,151
102772,131 GRAFTON TK,413/  4/  /  / ,413,4,  ,  3848/0046,14800,519500,372,6232,HWUNR-2,ELD,1,2021,0,519500,519500,0,2011-12-30,650000,2007-01-29,0,14800,14800,0,447800,447800,20:07:59,152
276,6 WILMOTT WY,401/  66/  /  / ,401,66,  ,  4196/0207,306500,306500,1.5,1010,SINGLE FAM MDL01,RD,1,2021,133100,173400,306500,299900,2016-01-04,140000,1994-08-15,122700,167400,290100,122700,167400,290100,20:08:00,153
278,50 RIVER RD,401/  68/  /  / ,401,68,  ,  4104/ 142,350300,472900,43.47,1010,SINGLE FAM MDL01,RD,1,2021,159300,313600,472900,0,2014-12-19,,,72200,168600,240800,72200,277900,350100,20:08:01,154
102897,60 ORFORD RD,408/  20/  /  / ,408,20,  ,  1633/0016,337800,352800,4.95,1093,MLTI HS WF,,4,2021,72500,280300,352800,0,1977-02-23,,,96500,216600,313100,96500,233500,330000,20:08:02,155
59,36 UNION ST,201/  39/  /  / ,201,39,  ,002867/0533,511800,511800,0.39,1010,SINGLE FAM MDL01,LCD,1,2021,355300,156500,511800,210000,2003-08-04,169000,2001-11-09,331100,165000,496100,331100,165000,496100,20:08:03,156
60,32 UNION ST,201/  40/  /  / ,201,40,  , ,704000,704000,1.55,1040,TWO FAMILY,LCD,1,2021,485100,218900,704000,0,,,,442800,192600,635400,442800,192600,635400,20:08:04,157
859,70 ORFORD RD,408/  22/  1000/  / ,408,22,1000,  1903/ 0413,1247700,1247700,13.45,3880,CABNCOLONY,RD,21,2021,343900,903800,1247700,0,1991-04-01,,,411500,459000,870500,411500,459000,870500,20:08:06,158
102976,ORFORD RD,408/  22/  2000/  / ,408,22,2000,  1903/0413,159000,502800,96.55,3880,CABNCOLONY,RD,1,2021,37100,465700,502800,0,1991-04-01,,,28500,93900,122400,28500,406000,434500,20:08:07,159
63,28 UNION ST,201/  43/  /  / ,201,43,  ,  4023/0682,490500,490500,2.55,111C,APT 4-UNT  MDL-94,LCD,1,2021,258400,232100,490500,0,2013-11-06,160000,1989-02-27,182300,204300,386600,182300,204300,386600,20:08:08,160
64,26 UNION ST,201/  44/  /  / ,201,44,  ,  2161/0118,322100,322100,1.6,1010,SINGLE FAM MDL01,LCD,1,2021,103900,218200,322100,80000,1995-09-22,,,100700,161800,262500,100700,161800,262500,20:08:09,161
66,22 UNION ST,201/  46/  /  / ,201,46,  ,  3368/0837,449700,449700,1.28,1040,TWO FAMILY,LCD,1,2021,218800,230900,449700,0,2007-01-12,,,205200,203200,408400,205200,203200,408400,20:08:10,162
68,5 BROOK LN,201/  48/  /  / ,201,48,  ,  3695/0434,284100,284100,2.3,1010,SINGLE FAM MDL01,RD,1,2021,127000,157100,284100,0,2010-04-21,,,136000,120600,256600,136000,120600,256600,20:08:12,163
69,4 BROOK LN,201/  49/  /  / ,201,49,  , ,8600,8600,0.41,9010,STATE NH,RD,1,2021,0,8600,8600,0,,,,0,8400,8400,0,8400,8400,20:08:13,164
76,11 UNION ST,201/  51/  1000/  / ,201,51,1000,  4086/0348,754200,754200,2,1010,SINGLE FAM MDL01,LCD,1,2021,519800,234400,754200,515000,2014-10-03,150000,1986-06-30,537500,206400,743900,537500,206400,743900,20:08:14,165
78,15 UNION ST,201/  52/  /  / ,201,52,  ,  2809/0420,390300,390300,1,1010,SINGLE FAM MDL01,LCD,1,2021,173800,216500,390300,225000,2003-04-25,,,132600,190400,323000,132600,190400,323000,20:08:14,166
79,17 UNION ST,201/  53/  /  / ,201,53,  ,  0909/0569,333300,333300,0.99,1010,SINGLE FAM MDL01,LCD,1,2021,116800,216500,333300,0,,,,105400,190200,295600,105400,190200,295600,20:08:15,167
80,21 UNION ST,201/  54/  /  / ,201,54,  , ,618800,618800,18,906R,CHURCH ETC  MDL-01,LCD,1,2021,301600,317200,618800,0,,,,226900,265000,491900,226900,265000,491900,20:08:16,168
81,25 UNION ST,201/  55/  /  / ,201,55,  ,  1659/0083,429800,429800,1.4,130,PRI RES,LCD,1,2021,139400,290400,429800,190000,1987-03-01,,,119100,255500,374600,119100,255500,374600,20:08:17,169
82,27 UNION ST,201/  56/  /  / ,201,56,  ,  3046/0166,417000,417000,0.67,1040,TWO FAMILY,LCD,1,2021,217700,199300,417000,210000,2004-08-12,133000,1986-06-03,157800,186800,344600,157800,186800,344600,20:08:18,170
84,35 UNION ST (ELEM SCHOOL),201/  58/  /  / ,201,58,  , ,5187300,5187300,6.8,903C,MUNICPAL  MDL-94,LCD,1,2021,3187200,2000100,5187300,0,,,,2800400,1387500,4187900,2800400,1387500,4187900,20:08:19,171
85,39 UNION ST (LITTLE COMMON),201/  59/  /  / ,201,59,  , ,16900,16900,0.38,9035,TOWN-PROP,LCD,1,2021,0,16900,16900,0,,,,0,16400,16400,0,16400,16400,20:08:20,172
86,37 UNION ST,201/  60/  /  / ,201,60,  ,  3138/0802,700600,700600,1.1,1010,SINGLE FAM MDL01,LCD,1,2021,471700,228900,700600,513000,2005-05-11,,,422300,201400,623700,422300,201400,623700,20:08:21,173
87,19 EAST THETFORD RD,201/  61/  /  / ,201,61,  ,4083-0169,635700,635700,1.5,1010,SINGLE FAM MDL01,LCD,1,2021,379700,256000,635700,660000,2014-09-16,,,373400,225400,598800,373400,225400,598800,20:08:22,174
91,2 HAMILTON LN,201/  65/  /  / ,201,65,  ,  2866/0001,803300,803300,0.81,1090,MULTI HSES,LCD,2,2021,526300,277000,803300,0,2012-03-06,135000,1988-06-08,548900,191900,740800,548900,191900,740800,20:08:23,175
92,8 EAST THETFORD RD,201/  66/  /  / ,201,66,  ,  3677/0115,257300,257300,0.67,1010,SINGLE FAM MDL01,LCD,1,2021,77800,179500,257300,0,2010-01-20,102000,1995-01-09,63100,149400,212500,63100,149400,212500,20:08:24,176
93,6 EAST THETFORD RD,201/  67/  /  / ,201,67,  ,  4321/0698,680100,680100,0.7,1010,SINGLE FAM MDL01,LCD,1,2021,475800,204300,680100,589000,2017-10-30,485000,2008-09-16,298700,188200,486900,298700,188200,486900,20:08:24,177
94,4 EAST THETFORD RD,201/  68/  /  / ,201,68,  ,  2263/0290,564700,564700,0.55,1010,SINGLE FAM MDL01,LCD,1,2021,385500,179200,564700,208000,1997-07-29,126600,1993-10-06,266600,178700,445300,266600,178700,445300,20:08:25,178
99,1 MAIN          ST (33% INT),201/  70/  0010/  / ,201,70,10,  4023/0680,328500,328500,0,340C,OFF CONDO  MDL-94,LCD,1,2021,328500,0,328500,0,2013-11-06,123810,1993-07-21,308800,0,308800,308800,0,308800,20:08:27,179
101,1 MAIN          ST (67% INT),201/  70/  0020/  / ,201,70,20,  4023/0680,543900,543900,0,340C,OFF CONDO  MDL-94,LCD,2,2021,543900,0,543900,0,2013-11-06,215048,1992-12-31,543200,0,543200,543200,0,543200,20:08:29,180
103,10 LATHAM LN,201/  72/  /  / ,201,72,  ,  3650/0629,306900,306900,1.4,1010,SINGLE FAM MDL01,LCD,1,2021,121800,185100,306900,274533,2009-10-02,3800,2008-03-25,116200,162700,278900,116200,162700,278900,20:08:30,181
104,5 MAIN ST,201/  73/  /  / ,201,73,  ,  3457/0514,1449300,1449300,0.96,3220,STORE/SHOP  MDL-94,LCD,1,2021,1055000,394300,1449300,500000,2007-10-12,400000,1987-01-02,923900,298600,1222500,923900,298600,1222500,20:08:31,182
105,7 MAIN ST,201/  74/  /  / ,201,74,  ,  3452/0881,510400,510400,0.4,3400,OFFICE BLD  MDL-94,LCD,1,2021,236100,274300,510400,0,2007-09-13,225000,1988-06-24,219000,249200,468200,219000,249200,468200,20:08:31,183
106,9 MAIN ST,201/  75/  /  / ,201,75,  ,  2305/0161,1909300,1909300,5.4,3020,INNS,LCD,3,2021,1421000,488300,1909300,0,1998-03-06,400000,1989-05-15,1164400,388300,1552700,1164400,388300,1552700,20:08:32,184
107,13 MAIN ST,201/  76/  /  / ,201,76,  ,  3045/0960,623200,623200,0.31,3220,STORE/SHOP  MDL-94,LCD,2,2021,359500,263700,623200,0,2004-08-30,450000,1988-01-18,340500,233900,574400,340500,233900,574400,20:08:33,185
111,1 PLEASANT ST (OLD CEMETERY,201/  78/  /  / ,201,78,  , ,429100,429100,3.7,9035,TOWN-PROP,,1,2021,4400,424700,429100,0,,,,4000,337700,341700,4000,337700,341700,20:08:34,186
102937,ROW  TOWN OF LYME,100/  5/  /  / ,100,5,  ,  0000/0000,6000,6000,0,3900,DEVEL LAND,,1,2021,6000,0,6000,0,2001-01-01,,,5000,0,5000,5000,0,5000,20:08:35,187
120,4 BRITTON LN,201/  83/  /  / ,201,83,  ,  4421/0347,822900,822900,4.2,3160,COMM WHSE,LCD,1,2021,462100,360800,822900,675000,2019-03-18,4000,1989-01-25,461500,277700,739200,461500,277700,739200,20:08:37,188
121,34 PLEASANT ST,201/  84/  /  / ,201,84,  ,  3729/0847,146100,146100,1.4,1010,SINGLE FAM MDL01,LCD,1,2021,2400,143700,146100,115000,2010-09-10,242533,2005-09-23,73600,115200,188800,73600,115200,188800,20:08:37,189
689,22 POST POND LN,407/  29/  /  / ,407,29,  ,  4425/0328,463000,508400,12.2,1010,SINGLE FAM MDL01,RD,1,2021,301300,207100,508400,385000,2019-04-05,440000,2008-04-10,223400,142500,365900,223400,183700,407100,20:08:38,190
690,16 POST POND LN,407/  30/  /  / ,407,30,  ,  3990/0020,926900,926900,3.7,1010,SINGLE FAM MDL01,RD,1,2021,726400,200500,926900,770000,2013-06-25,850000,2008-05-06,591800,191700,783500,591800,191700,783500,20:08:39,191
102737,51 HIGH ST,201/  134/  /  / ,201,134,  ,  4238/0547,1041400,1041400,9.9,1010,SINGLE FAM MDL01,LCD,1,2021,672900,368500,1041400,360000,2016-10-03,209000,2006-06-26,569100,324800,893900,569100,324800,893900,20:08:40,192
691,11 NORTH THETFORD RD,407/  31/  /  / ,407,31,  ,  4179/ 118,613500,666400,23.28,101,Single Fam,RD,1,2021,400600,265800,666400,275000,2015-12-16,,,405100,169900,575000,405100,217300,622400,20:08:43,193
696,33 NORTH THETFORD RD,407/  36/  /  / ,407,36,  ,  1558/0885,493000,493000,4.7,1010,SINGLE FAM MDL01,RD,1,2021,301800,191200,493000,0,,,,294500,165700,460200,294500,165700,460200,20:08:44,194
697,7 TURNER LN,407/  37/  /  / ,407,37,  ,  4099/0876,364000,442500,11.19,1010,SINGLE FAM MDL01,RD,1,2021,227900,214600,442500,380000,2014-12-08,215050,1990-09-20,169800,153100,322900,169800,208400,378200,20:08:45,195
698,15 TURNER LN,407/  38/  /  / ,407,38,  ,  4538/ 990,665700,665700,4.7,1010,SINGLE FAM MDL01,,1,2021,486500,179200,665700,675733,2020-07-24,162000,1989-08-30,463100,180800,643900,463100,180800,643900,20:08:46,196
700,57 NORTH THETFORD RD,407/  40/  /  / ,407,40,  ,002842/0827,126500,126500,0.33,1030,MOBILE HOM  MDL-02,RD,1,2021,48900,77600,126500,45000,2003-06-24,,,40900,72900,113800,40900,72900,113800,20:08:47,197
701,52 NORTH THETFORD RD,407/  41/  /  / ,407,41,  ,  1680/ 554,384700,384700,4.2,1010,SINGLE FAM MDL01,,1,2021,208100,176600,384700,0,1987-06-30,,,151100,142000,293100,151100,142000,293100,20:08:48,198
702,48 NORTH THETFORD RD,407/  42/  /  / ,407,42,  ,  4533/ 221,365500,365500,3.2,1010,SINGLE FAM MDL01,,1,2021,216000,149500,365500,382000,2020-07-02,335000,2015-06-24,213600,119400,333000,213600,119400,333000,20:08:49,199
703,38 NORTH THETFORD RD,407/  43/  /  / ,407,43,  ,  PRO-/1995,258200,258200,6.5,1010,SINGLE FAM MDL01,RD,1,2021,66400,191800,258200,0,1995-02-24,38000,1970-08-24,57500,143600,201100,57500,143600,201100,20:08:49,200
704,8 PUSHEE FALLS LN,407/  44/  /  / ,407,44,  ,  1039/0179,295600,295600,1.3,1010,SINGLE FAM MDL01,RD,1,2021,146600,149000,295600,0,,,,128500,111800,240300,128500,111800,240300,20:08:50,201
705,4 PUSHEE FALLS LN,407/  45/  /  / ,407,45,  ,  1895/0176,10800,10800,1.6,1060,AC LND IMP,RD,1,2021,2000,8800,10800,0,1991-01-07,,,2000,8000,10000,2000,8000,10000,20:08:51,202
708,18 NORTH THETFORD RD,407/  48/  /  / ,407,48,  ,  4108/ 800,302500,302500,2.8,1010,SINGLE FAM MDL01,RD,1,2021,144900,157600,302500,0,2015-01-28,75000,2006-11-30,153200,119600,272800,153200,119600,272800,20:08:52,203
707,22 NORTH THETFORD RD,407/  47/  /  / ,407,47,  ,  4052/0529,381600,381600,3.8,1010,SINGLE FAM MDL01,RD,1,2021,210800,170800,381600,0,2014-04-30,336000,2002-07-15,218500,139600,358100,218500,139600,358100,20:08:53,204
725,1 CULVER HILL LN,407/  59/  /  / ,407,59,  ,  3229/0120,664300,748000,11.3,1010,SINGLE FAM MDL01,RD,1,2021,446600,301400,748000,550000,2005-12-27,750000,2002-08-28,390300,192300,582600,390300,268000,658300,20:08:54,205
734,1 TAVERN LN,407/  60/  1000/  / ,407,60,1000,  4058/0925,827200,827200,6.01,1010,SINGLE FAM MDL01,RD,1,2021,559500,267700,827200,715066,2014-05-30,540000,1999-09-10,527600,227300,754900,527600,227300,754900,20:08:54,206
735,3 TAVERN LN,407/  60/  2000/  / ,407,60,2000,  2560/0339,270500,270500,5.51,1300,RES ACLNDV,RD,1,2021,0,270500,270500,116000,2001-07-17,95000,1999-06-01,0,205100,205100,0,205100,205100,20:08:55,207
569,651 RIVER RD,405/  30/  1000/  / ,405,30,1000,  2397/0110,1128800,1241100,22.56,3020,INNS,,2,2021,732700,508400,1241100,632500,1999-06-03,958500,1999-04-22,802700,321300,1124000,802700,447800,1250500,20:08:56,208
616,376 ORFORD RD,406/  12/  /  / ,406,12,  ,  4334/0164,556900,556900,4.3,1040,TWO FAMILY,RD,1,2021,403700,153200,556900,0,2017-12-26,173000,1999-07-16,285900,118900,404800,285900,118900,404800,20:08:57,209
717,241 ORFORD RD,407/  54/  /  / ,407,54,  ,  4183/ 134,9600,447800,74.1,6610,SPI FARMR,RD,1,2021,0,447800,447800,400000,2016-01-07,,,0,9600,9600,0,405000,405000,20:08:58,210
719,236 ORFORD RD,407/  55/  /  / ,407,55,  ,  2105/0755,498900,622200,12.55,1010,SINGLE FAM MDL01,RD,1,2021,341500,280700,622200,150000,1994-08-15,160000,1989-12-02,222600,143600,366200,222600,143600,366200,20:08:59,211
723,186 ORFORD RD,407/  57/  /  / ,407,57,  ,  4385/0543,354700,354700,2.6,1010,SINGLE FAM MDL01,RD,1,2021,209100,145600,354700,234000,2018-08-31,90476,1993-07-30,136500,112000,248500,136500,112000,248500,20:09:00,212
724,15 WHIPPLE HILL RD,407/  58/  1000/  / ,407,58,1000,  4197/0226,21900,466700,58.8,6506,FARM-6,RD,1,2021,0,466700,466700,0,2016-03-29,,,0,22000,22000,0,425900,425900,20:09:01,213
738,41 CULVER HILL LN,407/  60/  5000/  / ,407,60,5000,  4623/ 491,646500,646500,9.55,1010,SINGLE FAM MDL01,RD,1,2021,375400,271100,646500,0,2021-04-22,535000,2013-03-19,354000,183600,537600,354000,183600,537600,20:09:01,214
740,48 CULVER HILL LN,407/  60/  7000/  / ,407,60,7000,  3736/0631,1002400,1002400,5.13,1090,MULTI HSES,RD,2,2021,668000,334400,1002400,960000,2010-09-29,616000,2001-08-01,651900,298400,950300,651900,298400,950300,20:09:02,215
741,63 CULVER HILL LN,407/  61/  /  / ,407,61,  ,  2528/0934,389300,509500,30,1010,SINGLE FAM MDL01,,1,2021,146100,363400,509500,2666,2001-04-04,,,120000,163100,283100,120000,270700,390700,20:09:03,216
742,56 CULVER HILL LN,407/  62/  /  / ,407,62,  ,  4121/0857,876100,946800,15.2,1010,SINGLE FAM MDL01,RD,1,2021,602000,344800,946800,0,2015-04-20,938000,2006-03-10,562800,252000,814800,562800,316100,878900,20:09:04,217
743,23 CLOVER MILL LN,407/  63/  /  / ,407,63,  ,  4600/ 687,551300,551300,9.32,1010,SINGLE FAM MDL01,RD,1,2021,256800,294500,551300,0,2021-02-08,430000,2012-08-25,254400,215800,470200,254400,215800,470200,20:09:05,218
744,20 CULVER HILL LN,407/  64/  /  / ,407,64,  ,  3276/0037,748000,878400,19.6,1010,SINGLE FAM MDL01,RD,1,2021,525500,352900,878400,810000,2006-05-01,43200,1998-11-25,446100,255900,702000,446100,333200,779300,20:09:06,219
745,37 WHIPPLE HILL RD,407/  65/  /  / ,407,65,  ,  4214/0312,7000,273700,21.7,6515,FARMR-5,,1,2021,0,273700,273700,0,2016-06-22,155000,1999-03-19,0,7000,7000,0,290000,290000,20:09:07,220
746,63 WHIPPLE HILL RD,407/  66/  /  / ,407,66,  ,  4214/0312,954900,954900,7.74,1010,SINGLE FAM MDL01,RD,1,2021,657300,297600,954900,0,2016-06-22,500000,1997-02-28,609500,263000,872500,609500,263000,872500,20:09:07,221
747,19 CLOVER MILL LN,407/  67/  /  / ,407,67,  ,  3991/0263,724800,724800,5.31,1010,SINGLE FAM MDL01,RD,1,2021,394000,330800,724800,199000,2013-06-27,1182533,2004-04-30,362200,228900,591100,362200,228900,591100,20:09:08,222
748,27 CLOVER MILL LN,407/  68/  /  / ,407,68,  ,  4220/0520,735800,842100,28.92,1010,SINGLE FAM MDL01,RD,1,2021,424400,417700,842100,740500,2016-07-09,214800,2012-07-02,373100,252700,625800,373100,349200,722300,20:09:09,223
102759,105 RIVER RD,402/  88/  /  / ,402,88,  ,  4102/0216,600,20100,2.1,6514,FARMR-4,RD,1,2021,0,20100,20100,550000,2014-12-19,,,0,600,600,0,16900,16900,20:09:10,224
749,28 CLOVER MILL LN,407/  69/  /  / ,407,69,  ,  4560/ 317,1540000,1651100,36.97,1010,SINGLE FAM MDL01,RD,1,2021,1062400,588700,1651100,1557500,2020-09-30,1087533,2003-09-29,1049800,378300,1428100,1049800,498000,1547800,20:09:11,225
750,16 CLOVER MILL LN,407/  70/  /  / ,407,70,  ,  4541/ 556,1198700,1198700,5.06,1010,SINGLE FAM MDL01,RD,1,2021,926200,272500,1198700,1188733,2020-07-31,935000,2012-10-05,822300,206900,1029200,822300,206900,1029200,20:09:12,226
751,79 WHIPPLE HILL RD,407/  71/  /  / ,407,71,  ,  4326/0549,469600,527800,11.74,1010,SINGLE FAM MDL01,RD,1,2021,299700,228100,527800,550000,2017-11-20,69524,1991-03-13,284300,142000,426300,284300,194800,479100,20:09:13,227
753,95 WHIPPLE HILL RD,407/  73/  /  / ,407,73,  ,  4658/ 842,829300,1036200,24.4,1010,SINGLE FAM MDL01,,1,2021,475900,560300,1036200,1230000,2021-08-13,834000,2017-09-18,415300,348400,763700,415300,446400,861700,20:09:14,228
754,101 WHIPPLE HILL RD,407/  74/  /  / ,407,74,  ,  4382/0524,686000,932600,79.9,101,Single Fam,RD,1,2021,506500,426100,932600,0,2018-08-20,635000,2006-07-31,499500,173600,673100,499500,397100,896600,20:09:14,229
755,111 WHIPPLE HILL RD,407/  75/  /  / ,407,75,  ,  1900/0774,340400,340400,2,1010,SINGLE FAM MDL01,,1,2021,167000,173400,340400,108762,1991-03-11,6400,1983-09-14,139600,115500,255100,139600,115500,255100,20:09:15,230
757,36 MUD TURTLE POND RD,407/  77/  /  / ,407,77,  ,  3634/0693,251800,251800,70,9030,MUNICPAL  MDL-00,RD,1,2021,0,251800,251800,0,2009-08-03,4000,1997-07-18,0,226900,226900,0,226900,226900,20:09:16,231
758,135 WHIPPLE HILL RD,407/  78/  /  / ,407,78,  ,  1822/ 991,288200,346200,20,1010,SINGLE FAM MDL01,,1,2021,122500,223700,346200,4000,1989-09-14,,,108400,128600,237000,108400,181200,289600,20:09:17,232
759,149 WHIPPLE HILL RD,407/  79/  /  / ,407,79,  ,  4509/ 214,281300,281300,5.45,1010,SINGLE FAM MDL01,,1,2021,103400,177900,281300,0,2020-04-01,1500,1968-05-29,95400,139500,234900,95400,139500,234900,20:09:18,233
279,38 RIVER RD,401/  69/  /  / ,401,69,  ,  1577/0653,338100,338100,3.5,1010,SINGLE FAM MDL01,RD,1,2021,161300,176800,338100,90000,1985-12-19,,,123600,148700,272300,123600,148700,272300,20:09:19,234
280,20 RIVER RD,401/  70/  /  / ,401,70,  ,  1578/ 947,8400,431500,63.5,6515,FARMR-5,RD,1,2021,0,431500,431500,0,,,,0,8400,8400,0,351300,351300,20:09:20,235
283,1 HOVEY ISLAND,401/  71/  /  / ,401,71,  ,  1903/0890,197100,197100,23,1013,SFR WATER  MDL-01,,2,2021,25500,171600,197100,0,1991-03-28,,,32600,130600,163200,32600,130600,163200,20:09:21,236
287,51 RIVER RD,401/  74/  /  / ,401,74,  ,  2666/0465,863600,863600,0.9,1013,SFR WATER  MDL-01,RD,1,2021,566500,297100,863600,2666,2002-05-10,25048,1992-08-03,518800,278200,797000,518800,278200,797000,20:09:22,237
288,61 RIVER RD,401/  75/  /  / ,401,75,  ,  3753/0938,573700,573700,1.9,1013,SFR WATER  MDL-01,RD,1,2021,245600,328100,573700,0,2010-12-01,90000,1984-07-26,204100,307200,511300,204100,307200,511300,20:09:23,238
102763,50 LAMPHIRE HILL LN,403/  35/  /  / ,403,35,  ,   PRO,3300,324900,34,6135,WPUNR-5,RD,1,2021,0,324900,324900,0,1997-07-22,,,0,3300,3300,0,267300,267300,20:09:25,239
290,75 RIVER RD,401/  77/  /  / ,401,77,  ,  4350/0949,908700,1072200,11.2,1010,SINGLE FAM MDL01,RD,1,2021,618200,454000,1072200,735000,2018-03-30,,,269000,281000,550000,269000,476100,745100,20:09:26,240
294,252 DARTMOUTH COLLEGE HY,402/  3/  /  / ,402,3,  ,  4535/ 866,591900,797500,37.3,1010,SINGLE FAM MDL01,RD,1,2021,411100,386400,797500,0,2020-07-13,210666,2001-10-03,378500,138900,517400,378500,325400,703900,20:09:27,241
295,246 DARTMOUTH COLLEGE HY,402/  4/  /  / ,402,4,  ,  4126/0865,236500,236500,0.53,1010,SINGLE FAM MDL01,RD,1,2021,132400,104100,236500,0,2015-04-30,,,130300,90500,220800,130300,90500,220800,20:09:27,242
296,246 DARTMOUTH COLLEGE HY,402/  4/  1/  / ,402,4,1,  4493/ 641,131100,131100,0,322L,COMM BLDG  MDL-96,RD,1,2021,131100,0,131100,0,2020-01-10,,,127600,0,127600,127600,0,127600,20:09:28,243
297,244 DARTMOUTH COLLEGE HY,402/  5/  /  / ,402,5,  ,  4126/0871,129200,129200,4.8,1060,AC LND IMP,RD,1,2021,40800,88400,129200,2667,2015-05-08,,,31400,70400,101800,31400,70400,101800,20:09:29,244
298,240 DARTMOUTH COLLEGE HY,402/  6/  /  / ,402,6,  ,  1250/0043,286300,286300,0.67,1010,SINGLE FAM MDL01,RD,1,2021,168100,118200,286300,0,,,,130400,95400,225800,130400,95400,225800,20:09:30,245
299,234 DARTMOUTH COLLEGE HY,402/  7/  /  / ,402,7,  ,  4010/0601,241600,241600,0.92,1010,SINGLE FAM MDL01,RD,1,2021,108200,133400,241600,150000,2013-09-11,,,100300,95400,195700,100300,95400,195700,20:09:31,246
300,232 DARTMOUTH COLLEGE HY,402/  8/  /  / ,402,8,  ,  1507/ 364,209900,209900,0.4,1010,SINGLE FAM MDL01,RD,1,2021,116500,93400,209900,0,,,,105200,84900,190100,105200,84900,190100,20:09:32,247
301,226 DARTMOUTH COLLEGE HY,402/  9/  /  / ,402,9,  ,  1481/0250,346000,432200,12.5,1010,SINGLE FAM MDL01,RD,1,2021,197200,235000,432200,40000,1983-08-22,,,150800,112000,262800,150800,189000,339800,20:09:32,248
187,40 PRESTON RD,401/  2/  /  / ,401,2,  ,  1342/0923,544300,695800,43.5,1010,SINGLE FAM MDL01,RD,2,2021,351200,344600,695800,0,,,,259400,131200,390600,259400,268200,527600,20:09:33,249
188,30 PRESTON RD,401/  3/  /  / ,401,3,  ,  4279/0380,547900,604600,13.87,1010,SINGLE FAM MDL01,RD,1,2021,329500,275100,604600,425000,2017-04-21,80000,2005-04-20,234300,161800,396100,234300,213100,447400,20:09:34,250
357,223 DARTMOUTH COLLEGE HY,402/  59/  /  / ,402,59,  ,  2072/0389,159000,159000,3.3,9200,NON PROFIT  MDL-00,RD,1,2021,0,159000,159000,0,1993-12-31,,,0,124500,124500,0,124500,124500,20:09:35,251
358,229 DARTMOUTH COLLEGE HY,402/  60/  /  / ,402,60,  ,  3894/0592,9300,9300,0.38,9200,NON PROFIT  MDL-00,RD,1,2021,0,9300,9300,0,2012-06-27,,,0,8400,8400,0,8400,8400,20:09:36,252
359,233 DARTMOUTH COLLEGE HY,402/  61/  /  / ,402,61,  ,  1513/0393,227500,227500,1.1,1010,SINGLE FAM MDL01,RD,1,2021,92400,135100,227500,0,1984-06-25,4500,1946-04-20,71900,97200,169100,71900,97200,169100,20:09:37,253
360,241 DARTMOUTH COLLEGE HY,402/  62/  /  / ,402,62,  ,  4202/0773,229900,229900,0.62,1010,SINGLE FAM MDL01,RD,1,2021,128100,101800,229900,0,2016-05-03,,,93600,84300,177900,93600,84300,177900,20:09:38,254
361,259 DARTMOUTH COLLEGE HY,402/  63/  /  / ,402,63,  ,  2292/0821,501200,712000,40,1010,SINGLE FAM MDL01,RD,1,2021,344600,367400,712000,4000,1998-01-14,218000,1987-08-10,315000,120400,435400,315000,311700,626700,20:09:39,255
115,21 PLEASANT ST,201/  79/  1000/  / ,201,79,1000,  4440/ 498,358900,479700,22,1010,SINGLE FAM MDL01,LCD,1,2021,221200,258500,479700,0,2019-06-06,,,168500,105400,273900,168500,214900,383400,20:09:40,256
116,23 PLEASANT ST,201/  79/  2000/  / ,201,79,2000,  2132/0258,397700,397700,2.08,1010,SINGLE FAM MDL01,LCD,1,2021,249500,148200,397700,0,1995-02-17,,,222400,119300,341700,222400,119300,341700,20:09:41,257
118,7 BRITTON LN,201/  81/  /  / ,201,81,  ,  3450/0372,560900,560900,5.3,3130,LUMBER YRD,RD,1,2021,155800,405100,560900,650000,2007-09-18,62500,1995-03-31,143400,287600,431000,143400,287600,431000,20:09:42,258
377,64 SHOESTRAP RD,402/  79/  /  / ,402,79,  ,  1041/0090,183700,497500,115,1010,SINGLE FAM MDL01,RD,1,2021,34900,462600,497500,0,,,,42400,102100,144500,42400,386700,429100,20:09:43,259
378,136 RIVER RD,402/  80/  /  / ,402,80,  ,  4657/ 199,488300,488300,0.63,1010,SINGLE FAM MDL01,RD,1,2021,345600,142700,488300,675000,2021-08-09,105000,2009-07-27,266300,122400,388700,266300,122400,388700,20:09:44,260
380,3 MAPLE LN,402/  82/  /  / ,402,82,  ,  4548/ 132,342200,342200,2.1,1010,SINGLE FAM MDL01,RD,1,2021,184800,157400,342200,0,2020-08-24,349000,2020-03-27,156000,125500,281500,156000,125500,281500,20:09:44,261
381,2 MAPLE LN,402/  83/  /  / ,402,83,  ,  4525/ 901,180800,180800,0.53,1010,SINGLE FAM MDL01,RD,1,2021,73000,107800,180800,190000,2020-06-08,147500,2016-03-30,61200,86800,148000,61200,86800,148000,20:09:45,262
835,96 ORFORD RD,407/  139/  /  / ,407,139,  ,  2123/0419,578200,578200,7.39,1010,SINGLE FAM MDL01,RD,2,2021,342000,236200,578200,0,1994-12-15,4000,1988-06-23,325000,172600,497600,325000,172600,497600,20:09:46,263
836,92 ORFORD RD,407/  140/  /  / ,407,140,  ,  4085/0657,18800,258500,14.84,1060,AC LND IMP,RD,1,2021,0,258500,258500,659000,2014-09-22,345000,2001-09-05,7700,15700,23400,7700,196600,204300,20:09:47,264
837,84 ORFORD RD,407/  141/  /  / ,407,141,  ,  4394/0498,728900,730100,1.59,1090,MULTI HSES,RD,3,2021,484200,245900,730100,0,2018-10-12,659000,2014-09-22,355900,146000,501900,355900,147100,503000,20:09:48,265
838,16 BRITTON LN,408/  1/  /  / ,408,1,  ,  4353/0607,400300,400300,4.1,1010,SINGLE FAM MDL01,RD,1,2021,258300,142000,400300,440000,2018-04-16,130000,1992-12-09,236500,110900,347400,236500,110900,347400,20:09:49,266
840,11 ORFORD RD,408/  3/  /  / ,408,3,  ,  4658/ 160,236800,236800,1.4,1010,SINGLE FAM MDL01,LCD,1,2021,106100,130700,236800,412000,2021-08-12,1000,2020-10-13,19400,99100,118500,19400,99100,118500,20:09:51,267
841,13 ORFORD RD,408/  4/  /  / ,408,4,  ,  3167/0671,749400,749400,1.3,3400,OFFICE BLD  MDL-94,RD,3,2021,543500,205900,749400,0,2005-07-13,,,507800,156800,664600,507800,156800,664600,20:09:52,268
842,15 ORFORD RD,408/  5/  /  / ,408,5,  ,  2372/0638,220300,220300,0.47,1010,SINGLE FAM MDL01,RD,1,2021,127100,93200,220300,0,2008-07-30,75000,1999-02-03,116200,83900,200100,116200,83900,200100,20:09:53,269
843,23 ORFORD RD,408/  6/  /  / ,408,6,  ,  3389/ 560,235800,235800,3.6,1010,SINGLE FAM MDL01,RD,1,2021,83600,152200,235800,0,2007-03-23,4000,1993-09-23,75700,118000,193700,75700,118000,193700,20:09:54,270
844,27 ORFORD RD,408/  7/  /  / ,408,7,  ,002936/0109,93200,301800,45.8,1013,SFR WATER  MDL-01,RD,1,2021,4300,297500,301800,0,2003-12-09,,,5900,79900,85800,5900,263800,269700,20:09:54,271
845,35 ORFORD RD,408/  8/  /  / ,408,8,  ,  1776/0056,353100,353100,2,1010,SINGLE FAM MDL01,RD,1,2021,211500,141600,353100,4000,1988-11-08,,,180800,108400,289200,180800,108400,289200,20:09:55,272
846,41 ORFORD RD,408/  9/  /  / ,408,9,  , ,113800,113800,3.8,9010,STATE NH,RD,1,2021,0,113800,113800,0,,,,0,87900,87900,0,87900,87900,20:09:56,273
849,92 POST POND LN (LAND ONLY),408/  12/  /  / ,408,12,  ,  1176/0426,117700,117700,19.6,9035,TOWN-PROP,RD,1,2021,0,117700,117700,0,,,,0,104600,104600,0,104600,104600,20:09:57,274
760,165 WHIPPLE HILL RD,407/  80/  /  / ,407,80,  ,  3897/0300,136500,289600,51.6,1300,RES ACLNDV,,1,2021,0,289600,289600,210000,2012-07-06,250000,2009-01-30,0,113100,113100,0,252100,252100,20:09:58,275
762,160 WHIPPLE HILL RD,407/  81/  /  / ,407,81,  ,002738/0562,500,181700,21.2,6303,OTM-3,,1,2021,0,181700,181700,112466,2002-10-31,20000,1990-02-06,0,500,500,0,147200,147200,20:09:59,276
765,132 WHIPPLE HILL RD,407/  84/  /  / ,407,84,  ,  4560/ 195,464100,536100,11.4,1010,SINGLE FAM MDL01,RD,1,2021,313700,222400,536100,527500,2020-09-30,347670,2000-05-10,313300,175800,489100,313300,247800,561100,20:10:00,277
101502,44 BLISS LN,410/  51/  /  / ,410,51,  ,  2549/0311,13400,13400,8.1,1320,RES ACLNUD,RD,1,2021,0,13400,13400,0,2001-04-27,,,0,11600,11600,0,11600,11600,20:10:00,278
101523,44 BRITTON LN,408/  1/  0100/  / ,408,1,100,  3084/0018,463400,596400,30.08,1010,SINGLE FAM MDL01,RD,1,2021,319000,277400,596400,0,2004-11-19,100000,2001-08-08,295500,105300,400800,295500,201800,497300,20:10:01,279
101542,675 RIVER RD,405/  33/  /  / ,405,33,  ,  2001/0552,531100,1292100,105.9,1013,SFR WATER  MDL-01,RD,1,2021,203700,1088400,1292100,0,2003-03-04,,,109800,271800,381600,109800,931600,1041400,20:10:02,280
769,144 ORFORD RD,407/  88/  /  / ,407,88,  ,  4475/ 933,345000,345000,3.15,1010,SINGLE FAM MDL01,RD,1,2021,195800,149200,345000,369000,2019-10-25,283000,2008-09-18,193700,115300,309000,193700,115300,309000,20:10:03,281
770,124 ORFORD RD,407/  89/  /  / ,407,89,  , ,6400,269900,25.52,6505,FARM-5,RD,1,2021,0,269900,269900,0,,,,0,6400,6400,0,233200,233200,20:10:04,282
101562,626 DORCHESTER RD,421/  22/  /  / ,421,22,  ,  4414/0586,16800,380000,213,1060,AC LND IMP,RD,1,2021,900,379100,380000,100000,2019-01-31,,,800,15600,16400,800,338100,338900,20:10:05,283
772,11 PINNACLE RD,407/  91/  /  / ,407,91,  ,  1613/0215,433300,433300,3,1010,SINGLE FAM MDL01,RD,1,2021,256700,176600,433300,141000,1986-08-07,,,250900,124800,375700,250900,124800,375700,20:10:06,284
306,69 WASHBURN HILL RD,402/  14/  /  / ,402,14,  ,  1424/ 471,474500,474500,3.1,1010,SINGLE FAM MDL01,RD,1,2021,254500,220000,474500,0,,,,173800,201400,375200,173800,201400,375200,20:10:07,285
307,77 WASHBURN HILL RD,402/  15/  1000/  / ,402,15,1000,  4114/0078,758500,860600,18.44,1010,SINGLE FAM MDL01,RD,1,2021,498100,362500,860600,0,2015-03-09,779000,2012-08-02,498800,229400,728200,498800,322000,820800,20:10:08,286
308,64 WASHBURN HILL RD,402/  16/  /  / ,402,16,  ,  1733/0962,476700,476700,3.31,1010,SINGLE FAM MDL01,RD,1,2021,280100,196600,476700,225000,1988-04-15,,,274500,150300,424800,274500,150300,424800,20:10:08,287
309,66 WASHBURN HILL RD,402/  17/  /  / ,402,17,  ,  4185/ 938,589800,854900,79.7,1010,SINGLE FAM MDL01,RD,1,2021,283000,571900,854900,700000,2016-01-29,220000,1985-02-27,264700,232900,497600,264700,473100,737800,20:10:09,288
310,108 PRESTON RD,402/  18/  2000/  / ,402,18,2000,  4619/ 634,694700,756100,15.78,1010,SINGLE FAM MDL01,RD,1,2021,511300,244800,756100,0,2021-04-09,150000,2004-05-04,475100,178800,653900,475100,234000,709100,20:10:10,289
313,50 PRESTON RD,402/  21/  /  / ,402,21,  ,  4537/0060,1105700,1337000,48.8,1010,SINGLE FAM MDL01,RD,1,2021,675600,661400,1337000,1325000,2020-07-16,1236800,2004-07-16,606600,485300,1091900,606600,695100,1301700,20:10:11,290
315,45 PRESTON RD,402/  23/  /  / ,402,23,  ,  2260/0768,659100,659100,7,1040,TWO FAMILY,,1,2021,484200,174900,659100,0,1997-06-03,30000,1988-05-03,437000,136800,573800,437000,136800,573800,20:10:12,291
316,55 PRESTON RD,402/  24/  /  / ,402,24,  ,  3200/0568,410200,410200,10,1010,SINGLE FAM MDL01,RD,1,2021,229500,180700,410200,380000,2005-09-30,,,228100,143200,371300,228100,143200,371300,20:10:13,292
319,69 PRESTON RD,402/  26/  1000/  / ,402,26,1000,  3669/0559,604700,604700,5.09,1010,SINGLE FAM MDL01,RD,1,2021,381800,222900,604700,0,2009-12-17,,,351600,172500,524100,351600,172500,524100,20:10:14,293
320,81 PRESTON RD,402/  26/  2000/  / ,402,26,2000,  3669/0559,9700,433100,57.7,6514,FARMR-4,RD,1,2021,0,433100,433100,0,2009-12-17,,,0,9700,9700,0,395000,395000,20:10:15,294
321,97 PRESTON RD,402/  27/  /  / ,402,27,  ,  1051/0565,215400,215400,1.1,1010,SINGLE FAM MDL01,RD,1,2021,74900,140500,215400,0,,,,67200,99000,166200,67200,99000,166200,20:10:15,295
322,20 WASHBURN HILL RD,402/  28/  /  / ,402,28,  , ,151200,273200,22,1300,RES ACLNDV,RD,1,2021,0,273200,273200,0,,,,0,115400,115400,0,226200,226200,20:10:16,296
323,218 DARTMOUTH COLLEGE HY,402/  29/  /  / ,402,29,  ,  4514/ 870,293100,293100,2,1010,SINGLE FAM MDL01,RD,1,2021,149300,143800,293100,299000,2020-04-27,188000,2015-04-01,119400,110400,229800,119400,110400,229800,20:10:17,297
324,208 DARTMOUTH COLLEGE HY,402/  30/  /  / ,402,30,  ,  4174/   8,457700,457700,1.5,1010,SINGLE FAM MDL01,RD,1,2021,319900,137800,457700,436000,2015-11-24,410000,2013-04-09,303200,99600,402800,303200,99600,402800,20:10:18,298
382,116 RIVER RD,402/  84/  /  / ,402,84,  ,  4059/0770,309800,309800,0.94,1010,SINGLE FAM MDL01,RD,1,2021,150900,158900,309800,286534,2014-06-03,4000,1993-06-01,131200,139200,270400,131200,139200,270400,20:10:19,299
384,91 RIVER RD,402/  86/  /  / ,402,86,  ,    PC/2003,356900,561800,18,1013,SFR WATER  MDL-01,RD,1,2021,115100,446700,561800,0,2003-01-01,4000,1993-04-23,34500,226600,261100,34500,404600,439100,20:10:20,300
385,101 RIVER RD,402/  87/  /  / ,402,87,  ,  1107/0355,458500,458500,1.55,1040,TWO FAMILY,RD,1,2021,285900,172600,458500,0,,,,248400,188900,437300,248400,188900,437300,20:10:22,301
387,111 RIVER RD (HEWES BROOK PRE,402/  89/  /  / ,402,89,  ,  2624/0731,32300,32300,1,9035,TOWN-PROP,RD,1,2021,0,32300,32300,0,2002-01-18,90000,1999-03-30,0,23100,23100,0,23100,23100,20:10:22,302
388,117 RIVER RD,402/  90/  /  / ,402,90,  ,  3938/0992,73500,73500,3.5,1320,RES ACLNUD,RD,1,2021,0,73500,73500,0,2012-12-11,,,0,60800,60800,0,60800,60800,20:10:23,303
390,129 RIVER RD,402/  92/  /  / ,402,92,  ,  3299/0718,454600,454600,8.6,1300,RES ACLNDV,RD,1,2021,0,454600,454600,550000,2006-06-26,4000,1988-10-12,0,397500,397500,0,397500,397500,20:10:24,304
391,131 RIVER RD,402/  93/  /  / ,402,93,  ,PRO-00044,469100,469100,1.3,1013,SFR WATER  MDL-01,RD,1,2021,147800,321300,469100,0,2009-09-12,500,1961-03-31,78600,252200,330800,78600,252200,330800,20:10:25,305
392,133+137 RIVER RD,402/  94/  /  / ,402,94,  ,  3536/0280,850400,850400,2.3,1013,SFR WATER  MDL-01,RD,1,2021,490100,360300,850400,0,2008-06-04,134000,1997-06-24,439200,285600,724800,439200,285600,724800,20:10:26,306
394,139 RIVER RD,402/  96/  /  / ,402,96,  ,  2084/0285,726500,726500,1.8,1093,MLTI HS WF,RD,2,2021,371100,355400,726500,110000,1994-04-01,68500,1986-09-17,366000,281200,647200,366000,281200,647200,20:10:27,307
395,143 RIVER RD,402/  97/  /  / ,402,97,  ,  3668/0759,654800,654800,2.33,1013,SFR WATER  MDL-01,RD,1,2021,319100,335700,654800,0,2009-12-08,99533,2005-10-14,289500,314100,603600,289500,314100,603600,20:10:27,308
102712,24 HIGH ST (HIGHLAND CEMETER,201/  110/  2000/  / ,201,110,2000,002888/0819,258000,258000,6.57,9030,MUNICPAL  MDL-00,LCD,1,2021,11100,246900,258000,0,2003-09-10,,,8300,183700,192000,8300,183700,192000,20:10:28,309
398,155 RIVER RD,402/  100/  /  / ,402,100,  ,  4662/ 466,2398500,2398500,2.15,1013,SFR WATER  MDL-01,RD,1,2021,777200,1621300,2398500,2500000,2021-08-24,99533,2005-10-14,601100,327800,928900,601100,327800,928900,20:10:29,310
399,161 RIVER RD,402/  101/  /  / ,402,101,  ,  4150/0104,649800,649800,1,1013,SFR WATER  MDL-01,RD,2,2021,352100,297700,649800,0,2015-08-12,300000,2002-09-05,312000,312000,624000,312000,312000,624000,20:10:30,311
400,207 RIVER RD,402/  102/  /  / ,402,102,  ,  4291/0231,502200,502200,1.8,1040,TWO FAMILY,RD,1,2021,339100,163100,502200,0,2017-06-20,200000,1997-06-11,312500,136600,449100,312500,136600,449100,20:10:31,312
402,261 RIVER RD,402/  104/  /  / ,402,104,  ,  3449/0254,2572100,2572100,6.6,1093,MLTI HS WF,RD,2,2021,1367100,1205000,2572100,1900000,2007-09-13,4000,1993-03-02,1353500,950900,2304400,1353500,950900,2304400,20:10:32,313
405,300 DARTMOUTH COLLEGE HY,403/  3/  /  / ,403,3,  ,  1873/ 112,291100,291100,1.2,1010,SINGLE FAM MDL01,RD,1,2021,147800,143300,291100,116685,1990-08-10,,,109200,109200,218400,109200,109200,218400,20:10:34,314
407,39 EAST THETFORD RD,403/  5/  /  / ,403,5,  ,  4489/ 718,13900,420900,41.08,6516,FARMR-6,RD,1,2021,0,420900,420900,0,2019-12-19,88000,1996-10-23,0,13900,13900,0,339600,339600,20:10:35,315
408,53 EAST THETFORD RD,403/  6/  /  / ,403,6,  ,  2206/0633,320000,320000,1,1010,SINGLE FAM MDL01,RD,1,2021,171500,148500,320000,199500,1996-07-09,,,139800,163400,303200,139800,163400,303200,20:10:36,316
415,79 EAST THETFORD RD,403/  8/  /  / ,403,8,  ,  2369/0009,455600,614500,24.03,1010,SINGLE FAM MDL01,RD,1,2021,242800,371700,614500,135200,1998-01-12,4000,1997-12-02,184700,163900,348600,184700,317800,502500,20:10:37,317
417,101 EAST THETFORD RD,403/  9/  /  / ,403,9,  ,  4257/0489,55700,643500,52.81,1060,AC LND IMP,RD,1,2021,34800,608700,643500,689000,2017-01-19,500000,2015-06-23,34200,17400,51600,34200,509600,543800,20:10:38,318
418,119 EAST THETFORD RD,403/  10/  /  / ,403,10,  ,  3787/0174,648600,648600,5.81,1010,SINGLE FAM MDL01,RD,1,2021,442900,205700,648600,0,2011-04-08,450000,2001-07-07,404000,207500,611500,404000,207500,611500,20:10:38,319
432,299 RIVER RD,403/  15/  /  / ,403,15,  ,  2515/0075,23700,23700,0.15,1320,RES ACLNUD,RD,1,2021,0,23700,23700,15000,2001-02-02,,,0,19200,19200,0,19200,19200,20:10:39,320
427,125 EAST THETFORD RD,403/  11/  /  / ,403,11,  ,  3731/0426,479800,479800,2.63,1010,SINGLE FAM MDL01,RD,1,2021,317000,162800,479800,420000,2010-09-14,410000,2007-10-10,260700,131000,391700,260700,131000,391700,20:10:40,321
101183, WHIPPLE HILL RD,407/  86/  3000/  / ,407,86,3000,  2524/0286,400,65400,8.34,6324,OTUN-4,RD,1,2021,0,65400,65400,0,2001-03-21,500000,1986-11-18,0,400,400,0,39600,39600,20:10:41,322
429,278 RIVER RD,403/  12/  /  / ,403,12,  ,  1948/0106,726100,816500,11.66,1010,SINGLE FAM MDL01,RD,1,2021,553700,262800,816500,345048,1992-01-23,,,474700,240800,715500,474700,322700,797400,20:10:42,323
101202, WHIPPLE HILL RD,407/  86/  4000/  / ,407,86,4000,  2524/0286,3100,231200,9.56,6325,OTUN-5,RD,1,2021,0,231200,231200,0,2001-03-21,500000,1986-11-18,0,2900,2900,0,183200,183200,20:10:43,324
100502,85 DARTMOUTH COLLEGE HY #4010,401/  55/  401/  / ,401,55,401,  4290/0281,421200,421200,0,1021,CONDO NL  MDL-05,BD,1,2021,421200,0,421200,487600,2017-06-14,395533,2009-09-01,385100,0,385100,385100,0,385100,20:10:43,325
100503,85 DARTMOUTH COLLEGE HY #4040,401/  55/  404/  / ,401,55,404,  4458/0140,261900,261900,0,1021,CONDO NL  MDL-05,BD,1,2021,261900,0,261900,327500,2019-08-16,250000,2016-10-24,197400,0,197400,197400,0,197400,20:10:44,326
434,303 RIVER RD,403/  17/  /  / ,403,17,  ,  2325/0701,242900,242900,0.21,1013,SFR WATER  MDL-01,RD,1,2021,58600,184300,242900,75000,1998-06-26,42857,1993-09-07,50400,122300,172700,50400,122300,172700,20:10:45,327
435,307 RIVER RD,403/  18/  /  / ,403,18,  ,  4647/ 931,325300,325300,0.15,1013,SFR WATER  MDL-01,RD,1,2021,104100,221200,325300,600000,2021-06-18,235000,2010-12-28,112300,164300,276600,112300,164300,276600,20:10:46,328
436,311 RIVER RD,403/  19/  /  / ,403,19,  ,  4417/0385,266100,266100,0.37,1030,MOBILE HOM  MDL-02,RD,1,2021,60300,205800,266100,0,2019-02-19,,,37300,165200,202500,37300,165200,202500,20:10:47,329
437,315 RIVER RD,403/  20/  /  / ,403,20,  ,002827/0123,1052700,1052700,0.92,1093,MLTI HS WF,RD,2,2021,674600,378100,1052700,0,2003-05-27,299000,1998-06-15,475100,298400,773500,475100,298400,773500,20:10:48,330
438,319 RIVER RD,403/  21/  /  / ,403,21,  ,PRO-00342,570500,570500,0.69,1040,TWO FAMILY,RD,1,2021,308800,261700,570500,0,2012-05-30,189000,1995-07-07,254000,232800,486800,254000,232800,486800,20:10:48,331
440,327 RIVER RD,403/  23/  /  / ,403,23,  ,  4508/ 505,281900,281900,0.58,1013,SFR WATER  MDL-01,RD,1,2021,53000,228900,281900,185000,2020-03-30,,,43900,179000,222900,43900,179000,222900,20:10:49,332
441,331 RIVER RD,403/  24/  /  / ,403,24,  ,002784/0404,848200,848200,3.7,1093,MLTI HS WF,RD,2,2021,393000,455200,848200,550000,2003-02-10,38000,1989-09-06,382300,346700,729000,382300,346700,729000,20:10:51,333
442,339 RIVER RD,403/  25/  /  / ,403,25,  ,002845/0276,426200,426200,0.66,1090,MULTI HSES,,2,2021,229500,196700,426200,0,2003-05-30,135000,1998-12-12,240600,162200,402800,240600,162200,402800,20:10:52,334
446,376 RIVER RD,403/  29/  1000/  / ,403,29,1000,  4502/ 178,634400,761900,93.05,1010,SINGLE FAM MDL01,RD,1,2021,417800,344100,761900,695000,2020-02-24,,,433400,302800,736200,433400,828900,1262300,20:10:52,335
447,37 LAMPHIRE HILL LN,403/  30/  /  / ,403,30,  ,  1953/0322,419700,419700,4.93,1010,SINGLE FAM MDL01,RD,1,2021,191200,228500,419700,160000,1992-02-19,,,151800,246200,398000,151800,246200,398000,20:10:53,336
448,41 LAMPHIRE HILL LN,403/  31/  /  / ,403,31,  ,  4162/ 277,652300,704400,16,1010,SINGLE FAM MDL01,RD,1,2021,396900,307500,704400,625000,2015-09-14,339500,2010-11-04,379100,188000,567100,379100,235200,614300,20:10:54,337
450,70 LAMPHIRE HILL LN,403/  33/  /  / ,403,33,  ,  4092/0497,958700,1618400,392.2,1090,MULTI HSES,RD,2,2021,561400,1057000,1618400,84000,2014-11-03,,,483000,396900,879900,483000,994400,1477400,20:10:55,338
454,34 LAMPHIRE HILL LN,403/  37/  /  / ,403,37,  ,PC-2005,830200,1426400,147,1010,SINGLE FAM MDL01,RD,1,2021,586400,840000,1426400,0,2005-04-23,,,471100,216400,687500,471100,750400,1221500,20:10:56,339
457,360 RIVER RD,403/  40/  /  / ,403,40,  ,  2242/0345,1044500,1228200,34.94,1010,SINGLE FAM MDL01,RD,1,2021,818800,409400,1228200,4000,1997-03-14,,,666000,293700,959700,666000,459900,1125900,20:10:57,340
458,336 RIVER RD,403/  41/  /  / ,403,41,  ,  4199/0809,507400,507400,5.1,1010,SINGLE FAM MDL01,RD,1,2021,234800,272600,507400,575000,2016-04-20,330000,2005-04-29,239700,235400,475100,239700,235400,475100,20:10:58,341
459,330 RIVER RD,403/  42/  /  / ,403,42,  ,  4203/0100,485400,485400,4.48,1010,SINGLE FAM MDL01,RD,1,2021,293400,192000,485400,0,2016-04-20,213333,1985-06-17,235200,206500,441700,235200,206500,441700,20:10:58,342
460,120 EAST THETFORD RD,403/  43/  /  / ,403,43,  ,  3899/0388,680900,758100,28.1,1010,SINGLE FAM MDL01,RD,1,2021,479100,279000,758100,0,2012-07-16,118500,1997-09-26,391500,167100,558600,391500,236900,628400,20:10:59,343
461,106 EAST THETFORD RD,403/  44/  /  / ,403,44,  ,  4405/0570,906400,985200,22,1010,SINGLE FAM MDL01,RD,1,2021,673400,311800,985200,200000,2018-12-07,2666,2002-05-10,299300,178200,477500,299300,249700,549000,20:11:00,344
462,84 EAST THETFORD RD,403/  45/  /  / ,403,45,  ,  3941/0106,737300,790700,13,1040,TWO FAMILY,RD,2,2021,544600,246100,790700,579533,2012-12-18,425048,1991-07-26,438100,119400,557500,438100,167700,605800,20:11:01,345
463,72 EAST THETFORD RD,403/  46/  /  / ,403,46,  ,PC-2005,4200,372200,30.68,6516,FARMR-6,RD,1,2021,0,372200,372200,0,2005-04-23,92000,1997-12-02,0,4200,4200,0,295500,295500,20:11:03,346
465,7 RECORDRIDGE LN,403/  47/  /  / ,403,47,  ,  3360/0554,12300,250900,36.2,6516,FARMR-6,RD,1,2021,0,250900,250900,800000,2006-12-08,525000,2001-08-09,0,12300,12300,0,195500,195500,20:11:04,347
469,15 RECORDRIDGE LN,403/  48/  /  / ,403,48,  ,  3360/0554,997000,997000,10.2,1010,SINGLE FAM MDL01,RD,1,2021,725500,271500,997000,800000,2006-12-08,525000,2001-08-09,598800,240800,839600,598800,240800,839600,20:11:05,348
472,26 RECORDRIDGE LN,403/  51/  /  / ,403,51,  ,  1950/0328,890300,956600,14.9,1010,SINGLE FAM MDL01,RD,1,2021,715000,241600,956600,135048,1992-01-31,123474,1990-01-10,586900,154400,741300,586900,214600,801500,20:11:06,349
473,24 RECORDRIDGE LN,403/  52/  /  / ,403,52,  ,  2013/0352,745500,745500,10.4,1010,SINGLE FAM MDL01,RD,1,2021,535100,210400,745500,85048,1993-02-17,104000,1991-07-01,427400,186100,613500,427400,186100,613500,20:11:07,350
474,20 RECORDRIDGE LN,403/  53/  /  / ,403,53,  ,002833/0065,558800,558800,5.7,1010,SINGLE FAM MDL01,,1,2021,358800,200000,558800,146000,2003-06-09,100000,1992-02-03,322500,176700,499200,322500,176700,499200,20:11:07,351
475,18 EAST THETFORD RD,403/  54/  /  / ,403,54,  ,  4102/0110,686600,851600,40.7,1040,TWO FAMILY,RD,1,2021,472000,379600,851600,500000,2014-12-19,,,492300,168200,660500,492300,317100,809400,20:11:08,352
476,23 STORRS HILL LN,404/  1/  /  / ,404,1,  ,  4471/ 712,477900,620200,37.4,1010,SINGLE FAM MDL01,RD,1,2021,285600,334600,620200,475000,2019-10-09,,,261600,155100,416700,261600,345100,606700,20:11:09,353
478,46 STORRS HILL LN,404/  3/  /  / ,404,3,  ,  3052/0110,461300,793000,215,1040,TWO FAMILY,RD,1,2021,270800,522200,793000,0,2004-09-07,,,218200,207000,425200,218200,506600,724800,20:11:10,354
479,28 STORRS HILL LN,404/  4/  /  / ,404,4,  ,  3621/0609,1058300,1359900,103,1010,SINGLE FAM MDL01,RD,1,2021,750500,609400,1359900,0,2009-06-24,395048,1992-04-24,724800,309400,1034200,724800,582700,1307500,20:11:11,355
480,97 NORTH THETFORD RD,404/  5/  /  / ,404,5,  ,  3378/0970,409400,479100,13.2,1010,SINGLE FAM MDL01,RD,1,2021,247100,232000,479100,0,2007-02-15,,,182700,129000,311700,182700,192300,375000,20:11:12,356
482,105 NORTH THETFORD RD,404/  7/  /  / ,404,7,  ,  3988/0223,462900,538100,15,1010,SINGLE FAM MDL01,RD,1,2021,308300,229800,538100,525000,2013-06-18,633200,2008-05-01,302700,122100,424800,302700,189400,492100,20:11:13,357
483,111 NORTH THETFORD RD,404/  8/  /  / ,404,8,  ,  3901/0778,700,700,0.06,1320,RES ACLNUD,RD,1,2021,0,700,700,0,2012-07-24,,,0,600,600,0,600,600,20:11:13,358
484,131 NORTH THETFORD RD,404/  9/  /  / ,404,9,  ,  4356/0716,613900,613900,2.3,1010,SINGLE FAM MDL01,RD,1,2021,431700,182200,613900,0,2018-04-30,97619,1993-09-23,387300,164200,551500,387300,164200,551500,20:11:14,359
486,161 NORTH THETFORD RD,404/  11/  /  / ,404,11,  ,  3389/0560,585900,585900,8.16,1110,APT 4-UNT  MDL-01,RD,1,2021,367800,218100,585900,0,2007-03-23,4000,1993-09-23,269200,196800,466000,269200,196800,466000,20:11:15,360
487,175 NORTH THETFORD RD,404/  12/  /  / ,404,12,  ,  3934/0421,345100,345100,1.84,1010,SINGLE FAM MDL01,RD,1,2021,165100,180000,345100,325000,2012-11-21,112000,1982-07-26,163300,162200,325500,163300,162200,325500,20:11:16,361
488,534 RIVER RD,404/  13/  /  / ,404,13,  ,  2037/0625,558200,558200,1.78,1010,SINGLE FAM MDL01,RD,1,2021,309400,248800,558200,146467,1993-06-21,20000,1960-12-14,228000,265200,493200,228000,265200,493200,20:11:17,362
490,526 RIVER RD,404/  15/  /  / ,404,15,  ,PRO-2004,501400,501400,0.98,1010,SINGLE FAM MDL01,RD,1,2021,289700,211700,501400,0,2004-11-18,,,195900,249200,445100,195900,249200,445100,20:11:18,363
492,520 RIVER RD,404/  17/  /  / ,404,17,  ,  3614/0968,323100,323100,5.83,1010,SINGLE FAM MDL01,RD,1,2021,124500,198600,323100,278533,2009-06-02,,,112200,145600,257800,112200,145600,257800,20:11:19,364
493,498 RIVER RD,404/  18/  /  / ,404,18,  ,  3224/0749,700600,1135900,66.1,1010,SINGLE FAM MDL01,RD,1,2021,442700,693200,1135900,0,2005-11-22,,,367000,295900,662900,367000,683200,1050200,20:11:20,365
494,474 RIVER RD,404/  19/  /  / ,404,19,  ,  4093/ 306,1267500,1538100,120,1080,SFR/ACC UNIT,RD,1,2021,978200,559900,1538100,362533,2014-11-05,,,888400,273600,1162000,888400,515400,1403800,20:11:21,366
495,429 RIVER RD,404/  20/  /  / ,404,20,  ,  3074/0149,641700,641700,7.36,1013,SFR WATER  MDL-01,RD,1,2021,308000,333700,641700,0,2004-09-15,262000,1995-06-29,240400,323400,563800,240400,323400,563800,20:11:22,367
501,535 RIVER RD,404/  26/  /  / ,404,26,  ,  1292/0257,262800,262800,0.96,1013,SFR WATER  MDL-01,RD,1,2021,63500,199300,262800,20500,1976-09-09,20000,1960-12-14,65000,159200,224200,65000,159200,224200,20:11:22,368
506,21 GREGORY RD,404/  31/  /  / ,404,31,  ,  3704/0784,937200,937200,9,1010,SINGLE FAM MDL01,,1,2021,580400,356800,937200,650000,2010-05-24,625000,2003-05-22,490100,315000,805100,490100,315000,805100,20:11:23,369
507,560 RIVER RD,404/  32/  /  / ,404,32,  ,  4505/0085,610500,979800,122.5,1090,MULTI HSES,RD,4,2021,326000,653800,979800,0,2020-03-09,4000,1994-01-04,283000,230900,513900,283000,562500,845500,20:11:24,370
509,25 BRECK HILL RD,404/  34/  /  / ,404,34,  ,  3988/0241,600200,600200,1.7,1010,SINGLE FAM MDL01,RD,1,2021,339400,260800,600200,612533,2013-06-18,295000,2005-08-23,346600,229600,576200,346600,229600,576200,20:11:25,371
510,7 GREGORY RD,404/  35/  /  / ,404,35,  ,  4120/0212,659900,749300,13.2,1010,SINGLE FAM MDL01,RD,1,2021,406200,343100,749300,700000,2015-04-09,950000,2006-04-14,383700,267900,651600,383700,348900,732600,20:11:26,372
512,40 BRECK HILL RD,404/  37/  /  / ,404,37,  ,  3819/0886,10200,265100,35.34,6506,FARM-6,RD,1,2021,0,265100,265100,140000,2011-09-13,,,0,10200,10200,0,212700,212700,20:11:27,373
513,34 BRECK HILL RD,404/  38/  /  / ,404,38,  ,  3595/0931,490500,490500,5.4,1010,SINGLE FAM MDL01,,1,2021,275900,214600,490500,0,2009-03-31,4286,1989-03-10,233800,249000,482800,233800,249000,482800,20:11:28,374
514,30 BRECK HILL RD,404/  39/  /  / ,404,39,  ,  3479/0593,643600,722300,14.46,1010,SINGLE FAM MDL01,RD,1,2021,365300,357000,722300,685000,2007-12-04,2667,2000-09-05,330700,302200,632900,330700,373200,703900,20:11:30,375
515,24 BRECK HILL RD,404/  40/  /  / ,404,40,  ,  1928/0356,361300,361300,2.7,1010,SINGLE FAM MDL01,RD,1,2021,173600,187700,361300,125524,1991-09-12,67000,1986-07-10,156900,180400,337300,156900,180400,337300,20:11:31,376
517,2 BRECK HILL RD,404/  42/  /  / ,404,42,  ,  3901/0778,513000,613500,16.4,1040,TWO FAMILY,RD,1,2021,331700,281800,613500,0,2012-07-24,,,279200,171100,450300,279200,262000,541200,20:11:31,377
519,108 NORTH THETFORD RD,404/  44/  /  / ,404,44,  ,  3389/0097,299000,299000,2.2,1010,SINGLE FAM MDL01,RD,1,2021,142100,156900,299000,0,2007-03-22,,,124600,125100,249700,124600,125100,249700,20:11:32,378
520,100 NORTH THETFORD RD,404/  45/  /  / ,404,45,  ,  4338/0634,687700,687700,3.8,1010,SINGLE FAM MDL01,RD,1,2021,482800,204900,687700,0,2018-01-18,,,392700,164000,556700,392700,164000,556700,20:11:33,379
522,88 NORTH THETFORD RD,404/  47/  /  / ,404,47,  ,  1646/ 722,295300,295300,2,1010,SINGLE FAM MDL01,RD,1,2021,133200,162100,295300,65000,1987-01-05,,,118100,116600,234700,118100,116600,234700,20:11:34,380
526,74 NORTH THETFORD RD,404/  48/  1000/  / ,404,48,1000,  1088/0339,350600,350600,6.23,1090,MULTI HSES,RD,1,2021,133300,217300,350600,0,,,,112300,155900,268200,112300,155900,268200,20:11:35,381
527,68 NORTH THETFORD RD,404/  48/  2000/  / ,404,48,2000,  2267/0853,520100,520100,5.78,1010,SINGLE FAM MDL01,,1,2021,312700,207400,520100,0,1997-08-06,,,342300,166300,508600,342300,166300,508600,20:11:36,382
530,59 BRECK HILL RD,405/  2/  /  / ,405,2,  ,  2468/0135,746100,760400,6.91,1010,SINGLE FAM MDL01,RD,1,2021,458500,301900,760400,280000,2000-05-09,,,496700,247700,744400,496700,258000,754700,20:11:37,383
102732,172 GOOSE POND RD,410/  76/  /  / ,410,76,  ,  3323/0687,105600,105600,0.46,1030,MOBILE HOM  MDL-02,RD,1,2021,36300,69300,105600,80000,2006-09-01,,,16600,62700,79300,16600,62700,79300,20:11:37,384
529,43 BRECK HILL RD,405/  1/  /  / ,405,1,  ,  4526/ 683,341000,341000,2.92,1010,SINGLE FAM MDL01,RD,1,2021,159300,181700,341000,0,2020-06-11,260000,2019-02-08,138200,145200,283400,138200,145200,283400,20:11:38,385
639,10 TAVERN LN,406/  36/  /  / ,406,36,  ,  3897/0317,1951500,2419800,75,1010,SINGLE FAM MDL01,RD,3,2021,1610400,809400,2419800,1825000,2012-07-02,140000,1999-04-30,1516800,250100,1766900,1516800,479600,1996400,20:11:39,386
625,280 ORFORD RD,406/  22/  1000/  / ,406,22,1000,  4447/0290,774200,774200,7.24,1010,SINGLE FAM MDL01,RD,1,2021,553700,220500,774200,798000,2019-07-01,585000,2003-07-08,583700,191200,774900,583700,191200,774900,20:11:40,387
532,89 BRECK HILL RD,405/  4/  /  / ,405,4,  ,  1807/ 510,241100,241100,5.07,1010,SINGLE FAM MDL01,RD,1,2021,58700,182400,241100,4000,1989-06-04,,,54400,160700,215100,54400,160700,215100,20:11:41,388
533,99 BRECK HILL RD,405/  5/  /  / ,405,5,  ,  4336/0984,757100,831200,14.53,1010,SINGLE FAM MDL01,RD,1,2021,561200,270000,831200,0,2018-01-08,700000,2012-06-05,497900,258900,756800,497900,324100,822000,20:11:42,389
643,105 ORFORD RD (LAND ONLY),407/  4/  /  / ,407,4,  ,  2507/0744,40400,40400,2.2,9035,TOWN-PROP,RD,1,2021,0,40400,40400,0,2000-12-20,20000,1992-07-17,0,37000,37000,0,37000,37000,20:11:43,390
648,41 POST POND LN,407/  9/  /  / ,407,9,  ,  3574/0925,1331000,1331000,2.2,1013,SFR WATER  MDL-01,RD,1,2021,838300,492700,1331000,1406200,2009-01-09,579000,1998-09-01,685900,638500,1324400,685900,638500,1324400,20:11:44,391
538,133 BRECK HILL RD,405/  9/  /  / ,405,9,  ,  4359/0442,552600,636400,18.29,1010,SINGLE FAM MDL01,,1,2021,377000,259400,636400,475000,2018-05-10,,,336800,176900,513700,336800,252900,589700,20:11:45,392
540,722 RIVER RD,405/  11/  /  / ,405,11,  ,  2343/0995,481300,597700,23.2,1010,SINGLE FAM MDL01,RD,1,2021,296800,300900,597700,0,1998-06-12,,,244500,199900,444400,244500,305400,549900,20:11:46,393
542,668 RIVER RD,405/  13/  /  / ,405,13,  ,  4348/0783,325500,325500,1.8,1010,SINGLE FAM MDL01,RD,1,2021,177800,147700,325500,276000,2018-03-19,,,164900,130300,295200,164900,130300,295200,20:11:46,394
543,664 RIVER RD,405/  14/  /  / ,405,14,  ,  4506/ 726,1500,54100,13.64,1320,RES ACLNUD,RD,1,2021,0,54100,54100,17000,2020-03-18,,,0,1400,1400,0,44300,44300,20:11:47,395
544,658 RIVER RD,405/  15/  /  / ,405,15,  ,  4182/ 178,233900,233900,1.2,1030,MOBILE HOM  MDL-02,RD,1,2021,62700,171200,233900,0,2016-01-02,,,47900,113500,161400,47900,113500,161400,20:11:48,396
545,652+654 RIVER RD,405/  16/  /  / ,405,16,  ,  4548/  52,270900,270900,0.98,1010,SINGLE FAM MDL01,RD,1,2021,102700,168200,270900,95000,2020-08-21,,,86300,111000,197300,86300,111000,197300,20:11:49,397
546,644 RIVER RD,405/  17/  /  / ,405,17,  ,  4575/ 214,282700,332900,14.7,1010,SINGLE FAM MDL01,RD,1,2021,115400,217500,332900,329900,2020-11-16,225000,2019-04-19,107900,132900,240800,107900,178400,286300,20:11:50,398
547,642 RIVER RD,405/  18/  /  / ,405,18,  ,  4379/0069,361300,361300,5.59,1010,SINGLE FAM MDL01,RD,1,2021,175800,185500,361300,0,2018-08-01,200000,1997-08-25,168900,156700,325600,168900,156700,325600,20:11:51,399
102814,111 ORFORD RD (REC AREA),407/  5/  1000/  / ,407,5,1000,   970/ 484,391900,391900,11.8,9030,MUNICPAL  MDL-00,RD,1,2021,49000,342900,391900,0,1962-05-09,,,42600,278300,320900,42600,278300,320900,20:11:51,400
552,614 RIVER RD,405/  21/  /  / ,405,21,  ,  1280/0667,137100,280000,41,1060,AC LND IMP,RD,1,2021,3600,276400,280000,0,,,,3500,118200,121700,3500,247500,251000,20:11:52,401
102815,115 ORFORD RD (CHAFFEE),407/  5/  2000/  / ,407,5,2000,  1319/ 422,126900,126900,21.02,9035,TOWN-PROP,RD,1,2021,0,126900,126900,0,1977-10-07,,,0,114900,114900,0,114900,114900,20:11:53,402
557,610 RIVER RD,405/  22/  1000/  / ,405,22,1000,  4163/ 244,318700,318700,8.9,1010,SINGLE FAM MDL01,,1,2021,114900,203800,318700,115066,2015-10-06,,,91600,151000,242600,91600,151000,242600,20:11:54,403
558,608 RIVER RD,405/  22/  2000/  / ,405,22,2000,  4558/ 218,207000,207000,2.4,1030,MOBILE HOM  MDL-02,RD,1,2021,45800,161200,207000,160000,2020-09-25,,,50400,127300,177700,50400,127300,177700,20:11:55,404
559,10 GREGORY RD,405/  23/  /  / ,405,23,  ,  1661/0770,447800,570700,11.5,1010,SINGLE FAM MDL01,RD,1,2021,300300,270400,570700,53635,1987-04-16,,,257700,179400,437100,257700,278200,535900,20:11:56,405
560,591 RIVER RD,405/  24/  /  / ,405,24,  ,  3389/ 560,286300,286300,1.6,1010,SINGLE FAM MDL01,RD,1,2021,123400,162900,286300,0,2007-03-23,4000,1993-09-23,123500,128700,252200,123500,128700,252200,20:11:57,406
561,597 RIVER RD (PORTER CEMETERY,405/  25/  /  / ,405,25,  , ,12200,12200,0.36,9035,TOWN-PROP,,1,2021,0,12200,12200,0,,,,0,11900,11900,0,11900,11900,20:11:59,407
102834,67  ACORN HILL RD,408/  63/  /  / ,408,63,  ,  4250/0161,1206400,1382700,32.13,1010,SINGLE FAM MDL01,RD,1,2021,860200,522500,1382700,410000,2016-11-22,,,756800,297800,1054600,756800,457400,1214200,20:11:59,408
563,609 RIVER RD,405/  27/  /  / ,405,27,  ,  3449/0926,580900,580900,7.6,1013,SFR WATER  MDL-01,RD,1,2021,344200,236700,580900,500000,2007-09-17,235000,1995-09-11,299500,204300,503800,299500,204300,503800,20:12:00,409
564,625 RIVER RD,405/  28/  /  / ,405,28,  ,  3165/0988,859800,1155300,54.6,1013,SFR WATER  MDL-01,RD,1,2021,497800,657500,1155300,650000,2005-07-14,,,421500,290600,712100,421500,550300,971800,20:12:01,410
565,639 RIVER RD,405/  29/  /  / ,405,29,  ,002884/0020,511500,580000,21,1010,SINGLE FAM MDL01,RD,1,2021,247800,332200,580000,0,2003-08-29,415000,2003-05-01,256000,188100,444100,256000,250200,506200,20:12:02,411
102874,177  GRAFTON TPK,413/  8/  /  / ,413,8,  ,  1397/0757,3800,207500,71,6324,OTUN-4,ELD,1,2021,0,207500,207500,0,1981-01-01,,,0,3800,3800,0,176900,176900,20:12:03,412
102766,616 RIVER RD,405/  20/  /  / ,405,20,  ,  4118/0695,346100,346100,1.8,1010,SINGLE FAM MDL01,RD,1,2021,171800,174300,346100,0,2015-04-02,,,169600,153300,322900,169600,153300,322900,20:12:04,413
102875,520  DORCHESTER RD,420/  27/  /  / ,420,27,  ,  4216/0484,13700,848300,370,6115,WPMR-5,ELD,1,2021,0,848300,848300,1300000,2016-06-27,1246000,2013-09-19,0,13700,13700,0,718400,718400,20:12:05,414
102768,29 HIGH ST,201/  128/  2000/  / ,201,128,2000,  2197/0241,109300,109300,2.77,1300,RES ACLNDV,LCD,1,2021,0,109300,109300,165000,1996-05-17,,,0,83800,83800,0,83800,83800,20:12:06,415
102916,94 NORTH THETFORD RD,404/  46/  /  / ,404,46,  ,  3937/0178,25000,294700,62,6505,FARM-5,RD,1,2021,0,294700,294700,186000,2012-12-04,140000,2010-05-09,0,25000,25000,0,238600,238600,20:12:07,416
1049,116 DORCHESTER RD,409/  94/  /  / ,409,94,  ,  3185/0660,192500,192500,17,1010,SINGLE FAM MDL01,RD,2,2021,31100,161400,192500,131266,2005-08-24,,,28800,132700,161500,28800,132700,161500,20:12:08,417
1051,98 DORCHESTER RD,409/  95/  /  / ,409,95,  ,  4662/  95,220800,220800,4.4,1030,MOBILE HOM  MDL-02,RD,1,2021,73600,147200,220800,2667,2021-08-09,205000,2006-04-18,66800,114100,180900,66800,114100,180900,20:12:09,418
1052,72 DORCHESTER RD,409/  96/  /  / ,409,96,  ,  1772/ 531,254300,379200,23.3,1010,SINGLE FAM MDL01,RD,1,2021,118300,260900,379200,4000,1988-11-02,,,73500,94100,167600,73500,207500,281000,20:12:09,419
1053,136 WASHBURN HILL RD,409/  98/  /  / ,409,98,  ,  4322/0033,1187500,1903600,249.3,1010,SINGLE FAM MDL01,RD,1,2021,859100,1044500,1903600,1700000,2017-11-01,1650000,2004-04-02,779800,366200,1146000,779800,1015800,1795600,20:12:10,420
1054,92 WASHBURN HILL RD,409/  99/  /  / ,409,99,  ,4123-0565,2085800,2482200,84,1080,SFR/ACC UNIT,RD,1,2021,1616600,865600,2482200,2650000,2015-04-28,1535000,2005-04-25,1158900,417200,1576100,1158900,776400,1935300,20:12:11,421
1055,100 EAST ST,409/  100/  /  / ,409,100,  ,  4519/ 340,16900,327000,113,6124,WPUN-4,RD,1,2021,0,327000,327000,328900,2020-05-14,,,0,16900,16900,0,199100,199100,20:12:12,422
1057,60 EAST ST,410/  2/  /  / ,410,2,  ,  4519/ 337,1700,72300,28.4,6224,HWUN-4,RD,1,2021,0,72300,72300,112133,2020-05-14,,,0,1700,1700,0,64800,64800,20:12:13,423
1060,232 BAKER HILL RD,410/  5/  /  / ,410,5,  ,002779/0048,1145300,1390700,44.4,1010,SINGLE FAM MDL01,RD,1,2021,952200,438500,1390700,0,2003-02-17,90000,1998-03-20,766000,147900,913900,766000,362100,1128100,20:12:14,424
804,66 HIGHBRIDGE RD,407/  113/  /  / ,407,113,  ,  4464/0258,689000,900100,47.7,1090,MULTI HSES,RD,2,2021,453900,446200,900100,0,2019-09-11,4000,1998-05-04,364800,170300,535100,364800,361800,726600,20:12:15,425
806,42 HIGHBRIDGE RD,407/  114/  /  / ,407,114,  ,  4359/0624,921500,1052000,21.3,1010,SINGLE FAM MDL01,RD,1,2021,715100,336900,1052000,912500,2018-05-11,865000,2015-06-24,545900,178900,724800,545900,294800,840700,20:12:15,426
807,41 HIGHBRIDGE RD,407/  115/  /  / ,407,115,  ,  4383/0493,14500,722500,205,6335,OTUNR-5,RD,1,2021,0,722500,722500,515000,2018-08-23,,,0,14500,14500,0,628800,628800,20:12:16,427
808,53 HIGHBRIDGE RD,407/  116/  /  / ,407,116,  ,  4137/0288,452600,452600,6.4,1010,SINGLE FAM MDL01,RD,1,2021,268500,184100,452600,429000,2015-06-22,175000,1994-06-06,227400,162700,390100,227400,162700,390100,20:12:17,428
809,65 HIGHBRIDGE RD,407/  117/  /  / ,407,117,  , ,377700,377700,5.09,1010,SINGLE FAM MDL01,RD,1,2021,194900,182800,377700,0,,,,157100,169000,326100,157100,169000,326100,20:12:18,429
810,85 HIGHBRIDGE RD,407/  118/  /  / ,407,118,  ,  4213/0942,1007500,1132200,16.45,1010,SINGLE FAM MDL01,RD,1,2021,747800,384400,1132200,1620000,2016-06-26,625000,1996-11-07,780200,262300,1042500,780200,375200,1155400,20:12:19,430
811,95 HIGHBRIDGE RD,407/  119/  /  / ,407,119,  ,  4534/ 526,232200,369700,29.92,1060,AC LND IMP,RD,1,2021,17300,352400,369700,0,2020-07-07,,,15100,191000,206100,15100,315900,331000,20:12:19,431
812,124 PINNACLE RD,407/  120/  /  / ,407,120,  ,  4157/  63,396700,471300,13.89,1010,SINGLE FAM MDL01,RD,1,2021,256800,214500,471300,0,2015-09-09,13000,1976-12-10,207600,107200,314800,207600,174900,382500,20:12:20,432
814,1 CUTTING HILL LN,407/  122/  /  / ,407,122,  ,  4043/0506,670300,670300,2.3,1010,SINGLE FAM MDL01,RD,1,2021,494100,176200,670300,0,2014-03-06,140000,2002-09-06,513600,155000,668600,513600,155000,668600,20:12:21,433
815,11 CUTTING HILL LN,407/  123/  /  / ,407,123,  ,  4533/ 658,630700,630700,10,1090,MULTI HSES,RD,2,2021,378600,252100,630700,608000,2020-07-06,,,334900,200900,535800,334900,200900,535800,20:12:22,434
820,19 CUTTING HILL LN,407/  125/  1000/  / ,407,125,1000,  2600/0174,1149500,1233600,12.5,1010,SINGLE FAM MDL01,RD,1,2021,954300,279300,1233600,2666,2001-11-02,360000,1995-07-31,839700,207500,1047200,839700,271700,1111400,20:12:23,435
821,47 HIGHBRIDGE RD,407/  125/  2000/  / ,407,125,2000,  2151/0999,1300,243100,21.6,6236,HWUNR-6,,1,2021,0,243100,243100,0,1995-07-31,,,0,1300,1300,0,200300,200300,20:12:24,436
824,98 PINNACLE RD,407/  128/  /  / ,407,128,  ,PC-0370,228800,228800,10,1010,SINGLE FAM MDL01,RD,1,2021,38200,190600,228800,0,2008-06-16,,,31300,146500,177800,31300,146500,177800,20:12:24,437
826,7 MASA MOREY LN,407/  130/  /  / ,407,130,  ,  3829/0418,509000,610200,29.8,1010,SINGLE FAM MDL01,RD,1,2021,301900,308300,610200,0,2011-10-25,29000,1986-11-19,278700,152800,431500,278700,244700,523400,20:12:25,438
827,43 MASA MOREY LN,407/  131/  /  / ,407,131,  ,  2713/0090,1315700,1649700,85.15,1090,MULTI HSES,RD,2,2021,749700,900000,1649700,2666,2002-09-10,700000,1994-01-14,728500,531300,1259800,728500,834100,1562600,20:12:26,439
829,64 PINNACLE RD,407/  133/  /  / ,407,133,  ,  4023/0682,688800,752100,19,1090,MULTI HSES,RD,3,2021,393900,358200,752100,0,2013-11-06,15000,1977-12-02,325300,210600,535900,325300,267600,592900,20:12:27,440
830,50 PINNACLE RD,407/  134/  /  / ,407,134,  ,  4023/0680,298700,298700,0.89,1010,SINGLE FAM MDL01,RD,1,2021,159900,138800,298700,0,2013-11-06,120000,2011-02-15,133400,93400,226800,133400,93400,226800,20:12:28,441
831,24 PINNACLE RD,407/  135/  /  / ,407,135,  ,  1835/ 703,1836000,1836000,38.1,1090,MULTI HSES,,3,2021,1136400,699600,1836000,205053,1989-12-01,168000,1989-05-15,1092100,661200,1753300,1092100,661200,1753300,20:12:29,442
834,4 PINNACLE RD,407/  138/  /  / ,407,138,  ,  2373/0736,276500,276500,0.69,1010,SINGLE FAM MDL01,RD,1,2021,156300,120200,276500,4000,1999-02-09,,,150100,100700,250800,150100,100700,250800,20:12:30,443
594,68 BRECK HILL RD,405/  47/  /  / ,405,47,  ,  3609/0957,763000,798800,8.01,1010,SINGLE FAM MDL01,,1,2021,541800,257000,798800,630000,2009-05-19,437950,1988-08-13,459400,224800,684200,459400,257300,716700,20:12:31,444
597,52 BRECK HILL RD,405/  50/  /  / ,405,50,  ,  3402/0127,992000,1089400,15.25,1010,SINGLE FAM MDL01,RD,1,2021,689900,399500,1089400,0,2007-04-24,,,623600,288500,912100,623600,376500,1000100,20:12:32,445
598,263 ORFORD RD (LAND ONLY),406/  1/  /  / ,406,1,  ,  2293/0700,35000,35000,8.8,9035,TOWN-PROP,RD,1,2021,0,35000,35000,0,1998-01-20,199000,1994-07-01,0,30000,30000,0,30000,30000,20:12:33,446
600,301 ORFORD RD,406/  3/  /  / ,406,3,  ,  4664/ 291,261800,261800,3.5,1010,SINGLE FAM MDL01,,1,2021,133000,128800,261800,307000,2021-09-02,240500,2020-12-08,137600,109600,247200,137600,109600,247200,20:12:35,447
603,385 ORFORD RD,406/  6/  /  / ,406,6,  ,  2980/0489,20600,250000,64,6515,FARMR-5,RD,1,2021,0,250000,250000,0,2004-04-08,,,0,20600,20600,0,254000,254000,20:12:36,448
605,393 ORFORD RD,406/  8/  /  / ,406,8,  ,  2997/0362,323000,323000,0.9,1010,SINGLE FAM MDL01,RD,1,2021,189700,133300,323000,0,2004-05-11,95000,1996-02-05,192500,100000,292500,192500,100000,292500,20:12:36,449
607,396 ORFORD RD,406/  10/  /  / ,406,10,  ,  4573/ 432,435600,435600,2.5,101,Single Fam,RD,2,2021,243800,191800,435600,0,2020-11-09,2667,2015-07-10,236400,133400,369800,236400,133400,369800,20:12:37,450
611,394 ORFORD RD,406/  11/  /  / ,406,11,  ,  3006/0740,838800,1132500,130,1010,SINGLE FAM MDL01,,1,2021,672000,460500,1132500,390000,2004-05-27,116250,1988-11-01,600800,150900,751700,600800,416800,1017600,20:12:38,451
102644,HORTON LN,408/  44/  /  / ,408,44,  ,  0000/0000,22700,147800,25,1010,SINGLE FAM MDL01,RD,1,2021,6300,141500,147800,0,2005-07-26,,,8300,11800,20100,8300,113200,121500,20:12:39,452
617,368 ORFORD RD,406/  14/  /  / ,406,14,  ,  4513/ 405,308500,308500,5.81,1010,SINGLE FAM MDL01,RD,1,2021,153300,155200,308500,245000,2020-04-21,100,1974-06-21,133900,126800,260700,133900,126800,260700,20:12:40,453
618,346 ORFORD RD,406/  15/  /  / ,406,15,  ,  1734/0766,267600,363200,59,1010,SINGLE FAM MDL01,RD,2,2021,83100,280100,363200,4000,1988-04-25,,,89400,138000,227400,89400,223900,313300,20:12:41,454
620,344 ORFORD RD,406/  17/  /  / ,406,17,  ,  4350/0491,6900,70300,85.1,6123,WPUN-3,RD,1,2021,0,70300,70300,20000,2018-03-29,38533,2015-07-17,0,6900,6900,0,63800,63800,20:12:42,455
621,328 ORFORD RD,406/  18/  /  / ,406,18,  ,  3205/0183,289600,350600,17.3,1010,SINGLE FAM MDL01,RD,1,2021,147400,203200,350600,0,2005-09-12,4000,1988-04-25,107100,114300,221400,107100,169600,276700,20:12:43,456
622,320 ORFORD RD,406/  19/  /  / ,406,19,  ,  3409/0340,236000,236000,1.75,1010,SINGLE FAM MDL01,RD,1,2021,97700,138300,236000,235000,2007-05-22,,,94200,110600,204800,94200,110600,204800,20:12:44,457
102736,25 LAMPHIRE HILL LN,403/  29/  2000/  / ,403,29,2000,  3337/0439,618200,692900,13.99,1010,SINGLE FAM MDL01,RD,1,2021,425900,267000,692900,0,2006-10-13,,,394900,192000,586900,394900,259700,654600,20:12:45,458
623,314 ORFORD RD,406/  20/  /  / ,406,20,  ,  4311/0188,237200,299700,20,1010,SINGLE FAM MDL01,RD,1,2021,89500,210200,299700,0,2017-09-15,,,63100,99200,162300,63100,155500,218600,20:12:46,459
624,302 ORFORD RD,406/  21/  /  / ,406,21,  ,  1552/0633,448800,593000,42,101,Single Fam,RD,2,2021,301300,291700,593000,0,,,,281600,123900,405500,281600,254600,536200,20:12:47,460
626,264 ORFORD RD,406/  23/  /  / ,406,23,  ,  2152/0508,627400,725800,46.89,1010,SINGLE FAM MDL01,,1,2021,428100,297700,725800,213000,1995-08-01,199000,1994-07-01,317100,176300,493400,317100,265600,582700,20:12:47,461
627,129 CULVER HILL LN,406/  24/  /  / ,406,24,  ,  1852/0704,1100,32700,33,6710,UNPRODUCTIVE-REC,,1,2021,0,32700,32700,0,1990-02-21,,,0,1100,1100,0,29800,29800,20:12:48,462
633,85 ORFORDVILLE RD (TOWN FORE,406/  30/  /  / ,406,30,  , ,585800,585800,355,9035,TOWN-PROP,RD,1,2021,0,585800,585800,0,,,,0,521100,521100,0,521100,521100,20:12:49,463
634,111 MUD TURTLE POND RD,406/  31/  /  / ,406,31,  ,  4177/ 848,7700,287800,207,6213,HWMR-3,RD,1,2021,0,287800,287800,0,2015-12-08,,,0,7700,7700,0,260700,260700,20:12:50,464
635,121 MUD TURTLE POND RD,406/  32/  /  / ,406,32,  ,  3231/0776,4200,4200,0.96,1320,RES ACLNUD,RD,1,2021,0,4200,4200,0,2005-12-12,,,0,2900,2900,0,2900,2900,20:12:51,465
637,135 MUD TURTLE POND RD,406/  34/  /  / ,406,34,  ,  4384/0825,309800,309800,2,1010,SINGLE FAM MDL01,RD,1,2021,228800,81000,309800,0,2018-08-28,30000,2006-02-24,224000,48100,272100,224000,48100,272100,20:12:52,466
638,132+4 MUD TURTLE POND RD,406/  35/  /  / ,406,35,  ,    PC/2003,403900,524300,57,1090,MULTI HSES,RD,2,2021,279300,245000,524300,0,2003-01-01,,,267000,92700,359700,267000,201900,468900,20:12:52,467
645,149 ORFORD RD,407/  6/  /  / ,407,6,  ,  4258/0173,376700,376700,2.1,1010,SINGLE FAM MDL01,RD,1,2021,243400,133300,376700,376533,2017-01-19,135000,1988-11-03,240600,101500,342100,240600,101500,342100,20:12:53,468
647,31 POST POND LN,407/  8/  /  / ,407,8,  ,  1245/0279,288800,332800,11.6,1013,SFR WATER  MDL-01,RD,1,2021,30000,302800,332800,0,,,,21600,185800,207400,21600,233000,254600,20:12:54,469
650,47 POST POND LN,407/  11/  /  / ,407,11,  ,  3937/0345,418900,418900,0.39,1013,SFR WATER  MDL-01,RD,1,2021,183500,235400,418900,0,2012-12-04,105333,2012-12-04,187900,222000,409900,187900,222000,409900,20:12:56,470
651,49 POST POND LN,407/  12/  /  / ,407,12,  ,  2534/0476,461400,461400,0.52,1013,SFR WATER  MDL-01,RD,2,2021,183300,278100,461400,246000,2001-05-01,172500,1994-08-12,180700,244500,425200,180700,244500,425200,20:12:57,471
652,51 POST POND LN,407/  13/  /  / ,407,13,  ,  4123/0285,232200,232200,0.18,1013,SFR WATER  MDL-01,RD,1,2021,23900,208300,232200,0,2015-04-27,188000,2013-04-09,32100,154400,186500,32100,154400,186500,20:12:58,472
654,55 POST POND LN,407/  15/  /  / ,407,15,  ,  0794/0476,376200,484200,50.65,1013,SFR WATER  MDL-01,RD,1,2021,107000,377200,484200,0,1998-02-04,,,80800,196700,277500,80800,294600,375400,20:12:59,473
655,57 POST POND LN,407/  16/  /  / ,407,16,  ,   PRO/2002,913600,913600,1.31,1013,SFR WATER  MDL-01,RD,1,2021,480400,433200,913600,0,2002-01-01,99333,2001-08-08,421300,275600,696900,421300,275600,696900,20:13:00,474
103057,61 POST POND LN,407/  17/  /  / ,407,17,  ,  4516/ 586,657800,657800,0.64,1013,SFR WATER  MDL-01,,2,2021,327800,330000,657800,649500,2020-05-04,,,411500,237400,648900,411500,237400,648900,20:13:01,475
664,67 POST POND LN,407/  20/  /  / ,407,20,  ,  4041/0810,184100,184100,0.52,1013,SFR WATER  MDL-01,RD,1,2021,55700,128400,184100,0,2014-02-24,135200,2006-01-25,69800,107300,177100,69800,107300,177100,20:13:03,476
667,69 POST POND LN,407/  21/  /  / ,407,21,  ,  3495/0085,118900,118900,0.15,1013,SFR WATER  MDL-01,RD,1,2021,18200,100700,118900,0,2008-02-22,,,21800,65500,87300,21800,65500,87300,20:13:04,477
675,62 POST POND LN,407/  23/  /  / ,407,23,  ,  4041/0810,11300,52400,17.04,1320,RES ACLNUD,RD,1,2021,0,52400,52400,0,2014-02-24,153524,1993-02-18,0,10300,10300,0,47600,47600,20:13:05,478
686,50 POST POND LN,407/  26/  /  / ,407,26,  ,  2231/0147,11600,11600,4.2,9200,NON PROFIT  MDL-00,RD,1,2021,0,11600,11600,0,1996-12-09,4000,1992-04-09,0,10500,10500,0,10500,10500,20:13:05,479
688,32 POST POND LN,407/  28/  /  / ,407,28,  ,  4573/ 833,50200,50200,0.43,1060,AC LND IMP,RD,1,2021,2600,47600,50200,50000,2020-11-10,,,2300,50000,52300,2300,50000,52300,20:13:06,480
1469,637 DORCHESTER RD (LAND ONLY),421/  1/  /  / ,421,1,  , ,75600,75600,0.37,9035,TOWN-PROP,ELD,1,2021,0,75600,75600,0,,,,0,70600,70600,0,70600,70600,20:13:07,481
1471,641 DORCHESTER RD,421/  3/  /  / ,421,3,  ,  1694/0700,178800,178800,0.47,1013,SFR WATER  MDL-01,ELD,1,2021,13000,165800,178800,4000,1987-08-10,100,1937-05-10,13000,67300,80300,13000,67300,80300,20:13:08,482
1472,643 DORCHESTER RD,421/  4/  /  / ,421,4,  ,  4217/0127,287700,287700,1.43,1013,SFR WATER  MDL-01,ELD,1,2021,51300,236400,287700,205000,2016-06-28,,,44100,156400,200500,44100,156400,200500,20:13:09,483
1473,645 DORCHESTER RD,421/  5/  /  / ,421,5,  ,  4023/0682,439900,484000,16.14,1013,SFR WATER  MDL-01,ELD,3,2021,163200,320800,484000,0,2013-11-06,6267,2012-12-05,165800,161000,326800,165800,201100,366900,20:13:10,484
1475,651 DORCHESTER RD,421/  7/  /  / ,421,7,  ,  4023/0682,273500,308300,16.32,1013,SFR WATER  MDL-01,ELD,1,2021,32700,275600,308300,0,2013-11-06,6267,2012-12-05,46200,126000,172200,46200,157600,203800,20:13:11,485
1477,658 DORCHESTER RD,421/  9/  /  / ,421,9,  ,  3185/0233,234100,234100,1.91,1010,SINGLE FAM MDL01,ELD,1,2021,95100,139000,234100,430000,2005-08-26,,,79700,106000,185700,79700,106000,185700,20:13:12,486
101182,89 WASHBURN HILL RD,402/  1/  2000/  / ,402,1,2000,  4250/0538,789800,789800,7.92,1010,SINGLE FAM MDL01,RD,1,2021,457000,332800,789800,250000,2016-11-23,50000,2015-08-24,363200,293700,656900,363200,293700,656900,20:13:13,487
1484,41 OLD DORCHESTER RD,421/  16/  /  / ,421,16,  ,  3492/0834,271300,271300,3.67,1010,SINGLE FAM MDL01,ELD,1,2021,105200,166100,271300,0,2008-02-15,20000,1997-01-04,87300,123600,210900,87300,123600,210900,20:13:14,488
1485,636 DORCHESTER RD,421/  17/  /  / ,421,17,  ,  2071/0813,353900,353900,6.94,1010,SINGLE FAM MDL01,MFD,1,2021,152700,201200,353900,0,1993-01-08,121000,1990-03-05,120000,148400,268400,120000,148400,268400,20:13:15,489
1486,50 OLD DORCHESTER RD,421/  18/  /  / ,421,18,  ,  4650/ 312,390600,620500,76.33,1010,SINGLE FAM MDL01,ELD,1,2021,270400,350100,620500,725000,2021-07-16,96000,2009-07-30,256300,98100,354400,256300,253200,509500,20:13:16,490
1488,680 DORCHESTER RD,421/  20/  /  / ,421,20,  ,  1693/ 809,11200,332900,222,6233,HWUNR-3,MFD,1,2021,0,332900,332900,0,1987-09-14,,,0,11200,11200,0,296300,296300,20:13:17,491
1489,700 DORCHESTER RD,421/  21/  /  / ,421,21,  ,  4616/ 421,6400,459000,207.33,6213,HWMR-3,MFD,1,2021,0,459000,459000,2500000,2021-03-21,1125000,1999-03-19,0,6400,6400,0,277900,277900,20:13:17,492
292,294 DARTMOUTH COLLEGE HY,402/  1/  1000/  / ,402,1,1000,  2980/0489,550500,945700,86,1010,SINGLE FAM MDL01,RD,3,2021,376400,569300,945700,0,2004-04-08,,,317300,137000,454300,317300,495300,812600,20:13:18,493
505,599 RIVER RD,404/  30/  /  / ,404,30,  ,  2300/0153,1145800,1393700,29,1013,SFR WATER  MDL-01,RD,1,2021,704800,688900,1393700,180000,1998-02-27,121848,1986-12-17,615900,361700,977600,615900,571800,1187700,20:13:20,494
83,29 UNION ST,201/  57/  /  / ,201,57,  ,  2338/0377,351700,351700,0.44,1010,SINGLE FAM MDL01,LCD,1,2021,189900,161800,351700,155000,1998-08-28,115000,1985-03-28,151100,170400,321500,151100,170400,321500,20:13:21,495
171,18 SPRING HILL LN,201/  122/  /  / ,201,122,  ,  2253/ 229,200,144500,6.21,6335,OTUNR-5,LCD,1,2021,0,144500,144500,835000,1997-05-30,10000,1997-01-31,0,200,200,0,106000,106000,20:13:22,496
1099,43 PICO RD,410/  36/  /  / ,410,36,  ,  4601/ 508,432400,432400,6.7,1010,SINGLE FAM MDL01,RD,1,2021,237600,194800,432400,525000,2021-02-09,300000,2004-01-22,190800,109900,300700,190800,109900,300700,20:13:22,497
100184,85 DARTMOUTH COLLEGE HY #7010,401/  55/  701/  / ,401,55,701,  2729/0980,349600,349600,0,3401,OFF CONDO  MDL-06,BD,1,2021,349600,0,349600,70000,2002-10-25,153000,1998-10-09,356600,0,356600,356600,0,356600,20:13:23,498
194,8 GOODELL LN,401/  9/  /  / ,401,9,  ,  4519/ 352,100,22300,2.7,6324,OTUN-4,RD,1,2021,0,22300,22300,69000,2020-05-14,,,0,100,100,0,10800,10800,20:13:24,499
100202,345 GRAFTON TK,422/  1/  /  / ,422,1,  ,  3759/0955,20600,848400,752,6312,OTMR-2,MFD,1,2021,0,848400,848400,9013533,2010-12-17,,,0,20600,20600,0,766400,766400,20:13:25,500
100222,226 ORFORD RD,407/  56/  2000/  / ,407,56,2000,  3522/0988,2400,208600,5.61,6506,FARM-6,RD,1,2021,0,208600,208600,125000,2008-06-03,230000,1997-09-29,0,2100,2100,0,147000,147000,20:13:26,501
100262,215 ORFORD RD,407/  53/  1000/  / ,407,53,1000,  2345/0290,1008600,1084600,14.9,1010,SINGLE FAM MDL01,RD,1,2021,826700,257900,1084600,115000,1998-09-30,230000,1997-09-29,685200,194900,880100,685200,263500,948700,20:13:27,502
1243,321 DORCHESTER RD,414/  25/  /  / ,414,25,  ,  4232/0263,3400,299900,29,6235,HWUNR-5,RD,1,2021,0,299900,299900,0,2016-09-06,,,0,3400,3400,0,249500,249500,20:13:28,503
1046,150 DORCHESTER RD,409/  91/  /  / ,409,91,  ,  4299/0501,259300,259300,1.5,1010,SINGLE FAM MDL01,,1,2021,128000,131300,259300,165000,2017-07-24,195000,2010-11-22,121700,99600,221300,121700,99600,221300,20:13:29,504
1069,180 BAKER HILL RD,410/  10/  2000/  / ,410,10,2000,  4040/0205,1600,180000,12,6515,FARMR-5,RD,1,2021,0,180000,180000,0,2014-02-10,60300,2000-06-16,0,1600,1600,0,142400,142400,20:13:29,505
1071,159 BAKER HILL RD,410/  12/  /  / ,410,12,  ,  4513/ 311,635400,635400,2.26,1010,SINGLE FAM MDL01,RD,1,2021,496200,139200,635400,0,2020-04-30,385000,2005-08-26,452100,106500,558600,452100,106500,558600,20:13:30,506
1076,15 BAILEY HILL LN,410/  13/  2000/  / ,410,13,2000,  3765/0361,5300,220200,34.1,6515,FARMR-5,RD,1,2021,0,220200,220200,0,2011-01-05,60300,2000-06-16,0,5300,5300,0,180600,180600,20:13:31,507
1079,101 BEAR HILL LN,410/  16/  /  / ,410,16,  ,  3869/0217,100,66800,1.8,6133,WPUNR-3,RD,1,2021,0,66800,66800,0,2012-03-15,37000,2002-04-26,0,100,100,0,56200,56200,20:13:32,508
978,2 ACORN HILL RD,409/  31/  /  / ,409,31,  ,  4439/ 910,160200,160200,1.1,1010,SINGLE FAM MDL01,RD,1,2021,26100,134100,160200,141000,2019-06-03,135000,2008-10-31,22400,101900,124300,22400,101900,124300,20:13:33,509
100422,85 DARTMOUTH COLLEGE HY #2010,401/  55/  201/  / ,401,55,201,  4562/ 293,451200,451200,0,1021,CONDO NL  MDL-05,BD,2,2021,451200,0,451200,500000,2020-10-06,445000,2013-09-09,416300,0,416300,416300,0,416300,20:13:34,510
100442,85 DARTMOUTH COLLEGE HY #2020,401/  55/  202/  / ,401,55,202,  4229/0041,387700,387700,0,1021,CONDO NL  MDL-05,,1,2021,387700,0,387700,380000,2016-08-19,305000,2011-08-25,355600,0,355600,355600,0,355600,20:13:35,511
1199,10 CANAAN LEDGE LN,413/  26/  /  / ,413,26,  ,  4092/0766,258300,258300,2.1,1010,SINGLE FAM MDL01,ELD,1,2021,119800,138500,258300,220000,2014-11-05,126500,2000-06-20,106300,100200,206500,106300,100200,206500,20:13:36,512
100463,85 DARTMOUTH COLLEGE HY #2040,401/  55/  204/  / ,401,55,204,  4391/0802,398200,398200,0,1021,CONDO NL  MDL-05,BD,1,2021,398200,0,398200,0,2018-10-01,425000,2007-06-18,364500,0,364500,364500,0,364500,20:13:36,513
1196,18 CANAAN LEDGE LN,413/  23/  /  / ,413,23,  ,  4516/ 908,494300,494300,2.2,1010,SINGLE FAM MDL01,,1,2021,325600,168700,494300,525000,2020-05-04,555000,2017-06-28,347600,106300,453900,347600,106300,453900,20:13:37,514
100482,85 DARTMOUTH COLLEGE HY #4030,401/  55/  403/  / ,401,55,403,002845/0315,212900,212900,0,1021,CONDO NL  MDL-05,BD,1,2021,212900,0,212900,197533,2003-06-30,135000,1999-05-27,197100,0,197100,197100,0,197100,20:13:38,515
1200,6 CANAAN LEDGE LN,413/  27/  /  / ,413,27,  ,  4249/0469,296500,296500,2,1010,SINGLE FAM MDL01,ELD,1,2021,165800,130700,296500,252500,2016-11-18,129000,1999-11-18,121900,99800,221700,121900,99800,221700,20:13:39,516
100522,85 DARTMOUTH COLLEGE HY #5010,401/  55/  501/  / ,401,55,501,  4430/0449,184400,184400,0,1021,CONDO NL  MDL-05,BD,1,2021,184400,0,184400,195000,2019-05-02,166533,2003-06-20,171300,0,171300,171300,0,171300,20:13:40,517
100523,85 DARTMOUTH COLLEGE HY #5020,401/  55/  502/  / ,401,55,502,  4570/ 692,332100,332100,0,1021,CONDO NL  MDL-05,BD,1,2021,332100,0,332100,339000,2020-11-02,295000,2015-05-19,306200,0,306200,306200,0,306200,20:13:41,518
1214,57 POUT POND LN,414/  8/  /  / ,414,8,  ,  3896/0042,200,33200,5.03,6334,OTUNR-4,RD,1,2021,0,33200,33200,675000,2012-07-03,65000,1999-04-30,0,200,200,0,30200,30200,20:13:42,519
1229,67 SMITH MOUNTAIN RD,414/  16/  /  / ,414,16,  ,  2404/0604,67900,114700,11.3,1010,SINGLE FAM MDL01,RD,1,2021,34700,80000,114700,10000,1999-06-18,,,38700,29100,67800,38700,71600,110300,20:13:43,520
100602,64 BRECK HILL RD,405/  48/  /  / ,405,48,  ,  3609/0957,2100,92900,14.82,6136,WPUNR-6,RD,1,2021,0,92900,92900,630000,2009-05-19,37050,1988-09-01,0,2100,2100,0,84500,84500,20:13:44,521
100662,100 ORFORDVILLE RD,417/  6/  2000/  / ,417,6,2000,  4182/  49,2600,354300,44.55,6326,OTUN-6,RD,1,2021,0,354300,354300,440000,2015-12-23,200000,1997-10-02,0,2600,2600,0,289000,289000,20:13:45,522
100722,5 WILMOTT WY,401/  58/  /  / ,401,58,  ,  3989/0082,536300,536300,1.7,1010,SINGLE FAM MDL01,RD,1,2021,359600,176700,536300,440000,2013-06-20,172533,2005-07-22,248500,192600,441100,248500,192600,441100,20:13:46,523
659,65 POST POND LN,407/  19/  /  / ,407,19,  ,  4041/0810,13900,13900,0.17,1320,RES ACLNUD,RD,1,2021,0,13900,13900,0,2014-02-24,5050,1988-07-18,0,12100,12100,0,12100,12100,20:13:47,524
100742,19 MAPLE LN,402/  44/  /  / ,402,44,  ,  3167/0671,893400,991300,15,1080,SFR/ACC UNIT,RD,1,2021,674200,317100,991300,0,2005-07-13,222533,2003-05-28,346600,200800,547400,346600,283500,630100,20:13:47,525
1100,14 CLAFLIN LN,410/  37/  /  / ,410,37,  ,4040-0211,400,23100,8.4,6335,OTUNR-5,RD,1,2021,0,23100,23100,0,2014-02-10,125000,2000-01-28,0,400,400,0,21000,21000,20:13:49,526
100263,78 NORTH THETFORD RD,404/  50/  /  / ,404,50,  ,  3807/0462,812100,812100,8.63,1010,SINGLE FAM MDL01,RD,1,2021,609800,202300,812100,555000,2011-07-20,585000,2003-07-01,516000,171900,687900,516000,171900,687900,20:13:50,527
1169,137 GRAFTON TK,413/  5/  /  / ,413,5,  ,  4371/0696,718300,780000,13.9,1010,SINGLE FAM MDL01,ELD,1,2021,527000,253000,780000,0,2018-07-02,189000,1999-06-11,509600,146000,655600,509600,202000,711600,20:13:51,528
1103,75 PICO RD,410/  40/  /  / ,410,40,  ,  3950/0049,3100,353700,39.3,6335,OTUNR-5,RD,1,2021,0,353700,353700,82500,2013-01-24,189000,2011-07-05,0,3100,3100,0,299000,299000,20:13:52,529
1120,293 BAKER HILL RD,410/  57/  /  / ,410,57,  ,  3456/0827,534200,602700,24,1010,SINGLE FAM MDL01,RD,1,2021,370500,232200,602700,500000,2007-10-09,210000,2000-07-27,336800,140600,477400,336800,202600,539400,20:13:53,530
653,53 POST POND LN,407/  14/  /  / ,407,14,  ,  2426/0202,330900,330900,0.46,1013,SFR WATER  MDL-01,,1,2021,68500,262400,330900,125000,1999-10-15,35000,1993-08-09,94600,198400,293000,94600,198400,293000,20:13:54,531
673,72 POST POND LN,407/  22/  /  / ,407,22,  ,  4241/0173,239500,270400,12.71,1013,SFR WATER  MDL-01,,1,2021,44600,225800,270400,240000,2016-10-14,155000,2002-05-28,51500,141300,192800,51500,169300,220800,20:13:55,532
389,123 RIVER RD,402/  91/  /  / ,402,91,  ,  3763/0577,380400,380400,0.34,1010,SINGLE FAM MDL01,RD,1,2021,267800,112600,380400,36600,2010-12-30,54500,1999-09-10,266600,100400,367000,266600,100400,367000,20:13:56,533
433,301 RIVER RD,403/  16/  /  / ,403,16,  ,  2423/0460,142200,142200,0.14,1013,SFR WATER  MDL-01,RD,1,2021,37700,104500,142200,32500,1999-09-27,,,53300,76500,129800,53300,76500,129800,20:13:56,534
439,323 RIVER RD,403/  22/  /  / ,403,22,  ,PRO-00342,6400,6400,0.38,1320,RES ACLNUD,RD,1,2021,0,6400,6400,0,2012-05-30,8000,1999-06-18,0,5000,5000,0,5000,5000,20:13:57,535
449,39 LAMPHIRE HILL LN,403/  32/  /  / ,403,32,  ,  4507/ 562,221800,221800,3.5,1300,RES ACLNDV,RD,1,2021,0,221800,221800,0,2020-03-23,123000,2000-08-14,25800,165900,191700,25800,165900,191700,20:13:58,536
489,530 RIVER RD,404/  14/  /  / ,404,14,  ,  4425/0984,479200,479200,0.86,1013,SFR WATER  MDL-01,RD,1,2021,225500,253700,479200,473000,2019-04-09,389933,2015-02-04,306000,244300,550300,306000,244300,550300,20:13:59,537
491,522 RIVER RD,404/  16/  /  / ,404,16,  ,  4471/ 958,533400,919600,103,1010,SINGLE FAM MDL01,RD,1,2021,311300,608300,919600,500000,2019-10-09,4000,1996-01-12,439800,259200,699000,439800,607900,1047700,20:14:00,538
511,9 GREGORY RD,404/  36/  /  / ,404,36,  ,  2497/0846,408600,408600,2.5,1010,SINGLE FAM MDL01,RD,1,2021,196100,212500,408600,113000,2000-11-03,,,190500,202000,392500,190500,202000,392500,20:14:01,539
335,12 MAPLE LN,402/  41/  /  / ,402,41,  ,  3871/0366,260600,260600,2.7,1010,SINGLE FAM MDL01,RD,1,2021,103500,157100,260600,1,2012-03-23,177000,2002-05-31,121500,119100,240600,121500,119100,240600,20:14:02,540
337,17 MAPLE LN,402/  43/  /  / ,402,43,  ,  4414/0124,827800,827800,3,1090,MULTI HSES,RD,2,2021,630400,197400,827800,875000,2019-01-29,735000,2011-06-16,656400,120600,777000,656400,120600,777000,20:14:03,541
347,163 DARTMOUTH COLLEGE HY,402/  52/  /  / ,402,52,  ,  3519/0397,27400,302300,31,1060,AC LND IMP,RD,1,2021,8800,293500,302300,300000,2008-05-20,,,8200,16000,24200,8200,241900,250100,20:14:04,542
350,199 DARTMOUTH COLLEGE HY,402/  55/  /  / ,402,55,  ,  3767/0941,52200,52200,15.8,9200,NON PROFIT  MDL-00,RD,1,2021,0,52200,52200,0,2011-01-10,35000,1999-12-03,0,45700,45700,0,45700,45700,20:14:05,543
379,130 RIVER RD,402/  81/  /  / ,402,81,  ,  3931/0669,178600,178600,1,1030,MOBILE HOM  MDL-02,RD,1,2021,60600,118000,178600,0,2012-11-09,125000,2012-07-20,39200,104100,143300,39200,104100,143300,20:14:06,544
383,96 RIVER RD,401/  79/  /  / ,401,79,  ,  4102/0209,5000,376700,76,6235,HWUNR-5,RD,1,2021,0,376700,376700,200000,2014-12-19,,,0,5000,5000,0,314100,314100,20:14:07,545
208,47 GOOSE POND RD,401/  19/  /  / ,401,19,  ,  2430/0042,323000,323000,1.2,1010,SINGLE FAM MDL01,RD,1,2021,180600,142400,323000,0,1999-11-02,12000,1966-08-26,172800,98300,271100,172800,98300,271100,20:14:07,546
222,5 PELTON LN,401/  26/  /  / ,401,26,  ,  2421/0725,437800,437800,5.05,1010,SINGLE FAM MDL01,RD,1,2021,269100,168700,437800,227500,1999-09-28,46000,1995-10-10,232300,126700,359000,232300,126700,359000,20:14:08,547
102691,42 HARDSCRABBLE LN,415/  10/  /  / ,415,10,  ,  4573/ 775,1092900,1265100,35,1010,SINGLE FAM MDL01,RD,1,2021,791100,474000,1265100,0,2020-11-10,,,718300,355800,1074100,718300,475300,1193600,20:14:09,548
1061,216 BAKER HILL RD,410/  6/  /  / ,410,6,  ,  3971/0540,326400,326400,7.9,1061,ACESRYBLDG  MDL-01,RD,1,2021,132200,194200,326400,0,2013-04-18,320000,2009-02-02,123300,155500,278800,123300,155500,278800,20:14:10,549
1064,190 BAKER HILL RD,410/  9/  1000/  / ,410,9,1000,  2895/0200,692200,1013200,55.4,1010,SINGLE FAM MDL01,RD,1,2021,536700,476500,1013200,850000,2003-09-22,112942,1989-11-03,492900,121100,614000,492900,412100,905000,20:14:11,550
1068,172 BAKER HILL RD,410/  10/  1000/  / ,410,10,1000,  4188/ 546,813500,956900,40.52,1010,SINGLE FAM MDL01,RD,1,2021,620900,336000,956900,0,2015-12-23,490000,1996-08-12,607300,148600,755900,607300,278500,885800,20:14:12,551
325,204 DARTMOUTH COLLEGE HY,402/  31/  /  / ,402,31,  ,  2338/0366,1001800,1001800,5.9,3560,PROF ASSOC,RD,1,2021,750700,251100,1001800,150000,1998-08-26,77500,1997-05-09,713100,197900,911000,713100,197900,911000,20:14:13,552
795,121 PINNACLE RD,407/  104/  /  / ,407,104,  ,  1475/0329,397200,397200,3.3,1010,SINGLE FAM MDL01,RD,1,2021,236000,161200,397200,0,,,,200700,124300,325000,200700,124300,325000,20:14:13,553
796,153 PINNACLE RD,407/  106/  /  / ,407,106,  ,  2211/0032,149500,149500,0.32,1010,SINGLE FAM MDL01,RD,1,2021,55500,94000,149500,0,1996-08-05,4000,1994-12-14,48000,53000,101000,48000,53000,101000,20:14:14,554
797,1 ORFORDVILLE RD,407/  107/  /  / ,407,107,  ,  4074/0134,750300,750300,5.1,1080,SFR/ACC UNIT,RD,1,2021,535400,214900,750300,440000,2014-08-04,,,529200,183900,713100,529200,183900,713100,20:14:15,555
798,11 ORFORDVILLE RD,407/  108/  /  / ,407,108,  ,  3834/0242,154000,462500,183,1060,AC LND IMP,RD,1,2021,5400,457100,462500,100000,2011-11-10,,,5200,133200,138400,5200,411900,417100,20:14:16,556
801,92 HIGHBRIDGE RD,407/  111/  /  / ,407,111,  ,  2572/0510,611500,1074800,107.82,1010,SINGLE FAM MDL01,RD,1,2021,395700,679100,1074800,260000,2001-07-23,100000,1992-04-29,384700,192800,577500,384700,612000,996700,20:14:17,557
334,114 RIVER RD,402/  40/  /  / ,402,40,  ,  2095/0244,635200,778000,68.9,1010,SINGLE FAM MDL01,RD,1,2021,459600,318400,778000,110000,1994-06-15,50000,1973-12-31,375400,154800,530200,375400,284300,659700,20:14:18,558
336,11 MAPLE LN,402/  42/  /  / ,402,42,  ,  1614/0099,369000,369000,3.4,1010,SINGLE FAM MDL01,RD,1,2021,210700,158300,369000,26000,1986-08-13,,,205600,120200,325800,205600,120200,325800,20:14:18,559
339,48 SHOESTRAP RD,402/  45/  /  / ,402,45,  ,  3804/0607,293300,293300,0.95,1010,SINGLE FAM MDL01,RD,1,2021,153000,140300,293300,289000,2011-07-07,250000,2007-03-02,170300,89400,259700,170300,89400,259700,20:14:19,560
340,38 SHOESTRAP RD,402/  46/  /  / ,402,46,  ,  2328/0597,588200,588200,7.4,1010,SINGLE FAM MDL01,RD,1,2021,389200,199000,588200,310000,1998-07-14,180000,1989-07-07,350400,132800,483200,350400,132800,483200,20:14:22,561
341,30 SHOESTRAP RD,402/  47/  /  / ,402,47,  ,  4497/ 852,315400,315400,0.34,1090,MULTI HSES,RD,2,2021,191600,123800,315400,280000,2020-01-30,,,149100,80700,229800,149100,80700,229800,20:14:23,562
343,28 SHOESTRAP RD,402/  48/  /  / ,402,48,  ,  4060/0082,435600,435600,7,1010,SINGLE FAM MDL01,,1,2021,238400,197200,435600,385000,2014-06-04,287000,2003-01-22,220700,159000,379700,220700,159000,379700,20:14:25,563
344,16 SHOESTRAP RD,402/  49/  /  / ,402,49,  ,002772/0322,375000,770000,93,1010,SINGLE FAM MDL01,RD,1,2021,265500,504500,770000,0,2002-11-18,,,178700,100400,279100,178700,452100,630800,20:14:26,564
345,2 SHOESTRAP RD,402/  50/  /  / ,402,50,  ,  4120/0788,441600,441600,3.78,1010,SINGLE FAM MDL01,RD,1,2021,288300,153300,441600,274000,2015-04-13,13000,1959-07-06,248600,119100,367700,248600,119100,367700,20:14:27,565
346,155 DARTMOUTH COLLEGE HY,402/  51/  /  / ,402,51,  ,  3150/0794,416100,416100,0.87,904C,PRI SCHOOL  MDL-94,RD,1,2021,256900,159200,416100,100000,2005-06-10,30000,2002-08-30,195900,119000,314900,195900,119000,314900,20:14:28,566
355,215 DARTMOUTH COLLEGE HY,402/  57/  /  / ,402,57,  ,  2440/0567,330300,330300,122.4,9200,NON PROFIT  MDL-00,RD,1,2021,0,330300,330300,0,1999-07-30,6476,1992-08-11,0,279100,279100,0,279100,279100,20:14:29,567
348,173 DARTMOUTH COLLEGE HY,402/  53/  /  / ,402,53,  ,  3545/0975,436800,436800,3.18,1010,SINGLE FAM MDL01,RD,1,2021,287400,149400,436800,0,2008-08-29,251000,2003-10-30,301800,115500,417300,301800,115500,417300,20:14:29,568
349,183 DARTMOUTH COLLEGE HY,402/  54/  /  / ,402,54,  ,  1946/0430,102600,102600,37.3,9200,NON PROFIT  MDL-00,RD,1,2021,0,102600,102600,4000,1991-12-31,,,0,93300,93300,0,93300,93300,20:14:30,569
100542,85 DARTMOUTH COLLEGE HY #6010,401/  55/  601/  / ,401,55,601,  2619/0495,473800,473800,0,1021,CONDO NL  MDL-05,BD,1,2021,473800,0,473800,336000,2002-01-03,326500,2000-12-19,429200,0,429200,429200,0,429200,20:14:31,570
351,211 DARTMOUTH COLLEGE HY,402/  56/  /  / ,402,56,  , 00302/0580,433600,433600,3.1,1010,SINGLE FAM MDL01,RD,1,2021,284700,148900,433600,510000,2006-07-10,220000,1996-04-17,276100,115000,391100,276100,115000,391100,20:14:32,571
100543,85 DARTMOUTH COLLEGE HY #8010,401/  55/  801/  / ,401,55,801,  4385/0646,543400,543400,0,1021,CONDO NL  MDL-05,BD,1,2021,543400,0,543400,500000,2018-08-31,470000,2003-02-14,496700,0,496700,496700,0,496700,20:14:33,572
100562,85 DARTMOUTH COLLEGE HY #9010,401/  55/  901/  / ,401,55,901,  4281/0681,427400,427400,0,1021,CONDO NL  MDL-05,BD,2,2021,427400,0,427400,399000,2017-05-03,392000,2003-10-01,393600,0,393600,393600,0,393600,20:14:34,573
100563,85 DARTMOUTH COLLEGE HY #9020,401/  55/  902/  / ,401,55,902,  4366/0325,340300,340300,0,1021,CONDO NL  MDL-05,BD,1,2021,340300,0,340300,359000,2018-06-11,295000,2014-07-15,313300,0,313300,313300,0,313300,20:14:35,574
1127,239 GOOSE POND RD,410/  64/  /  / ,410,64,  ,  1467/0966,170400,354600,30,1060,AC LND IMP,RD,1,2021,50200,304400,354600,0,1983-04-04,,,39800,123100,162900,39800,264200,304000,20:14:35,575
1129,97 PICO RD,410/  66/  /  / ,410,66,  ,  4040/0176,100,107900,3.6,6335,OTUNR-5,RD,1,2021,0,107900,107900,0,2014-02-10,,,0,100,100,0,71800,71800,20:14:36,576
1131,252 GOOSE POND RD,410/  68/  /  / ,410,68,  ,  3664/0236,173300,392300,64.37,1010,SINGLE FAM MDL01,RD,1,2021,54200,338100,392300,320000,2009-11-23,5500,1964-07-03,30900,91200,122100,30900,289900,320800,20:14:37,577
1132,240 GOOSE POND RD,410/  69/  /  / ,410,69,  ,  1467/0966,769500,1140200,79,1010,SINGLE FAM MDL01,RD,1,2021,605600,534600,1140200,0,1983-04-04,,,529300,142800,672100,529300,479100,1008400,20:14:38,578
1133,216 GOOSE POND RD,410/  70/  /  / ,410,70,  ,  3785/0429,232500,232500,6.7,1010,SINGLE FAM MDL01,RD,1,2021,121200,111300,232500,175500,2011-04-08,92000,1996-09-03,85800,88100,173900,85800,88100,173900,20:14:39,579
1137,176 GOOSE POND RD,410/  74/  /  / ,410,74,  ,  1553/0914,101500,101500,0.6,1030,MOBILE HOM  MDL-02,RD,1,2021,26500,75000,101500,25000,1985-07-23,,,12800,62700,75500,12800,62700,75500,20:14:39,580
1138,174 GOOSE POND RD,410/  75/  /  / ,410,75,  ,  3569/0737,86500,86500,0.17,1010,SINGLE FAM MDL01,RD,1,2021,40000,46500,86500,139000,2008-12-09,,,32600,36700,69300,32600,36700,69300,20:14:40,581
1140,321 BAKER HILL RD,410/  77/  /  / ,410,77,  ,  4178/ 499,418900,418900,2.89,1010,SINGLE FAM MDL01,RD,1,2021,275600,143300,418900,0,2015-12-15,288000,2004-01-15,211300,84300,295600,211300,84300,295600,20:14:41,582
1141,327 BAKER HILL RD,410/  78/  /  / ,410,78,  ,  4178/ 499,3300,3300,0.76,1320,RES ACLNUD,RD,1,2021,0,3300,3300,0,2015-12-15,288000,2004-01-15,0,3000,3000,0,3000,3000,20:14:42,583
1142,331 BAKER HILL RD,410/  79/  /  / ,410,79,  ,  4635/ 438,220100,220100,7.9,1030,MOBILE HOM  MDL-02,RD,1,2021,68200,151900,220100,2800,2021-05-25,146000,2013-06-28,61500,96900,158400,61500,96900,158400,20:14:43,584
1144,347 BAKER HILL RD,410/  80/  /  / ,410,80,  ,  4528/ 957,528900,646400,40.8,1010,SINGLE FAM MDL01,RD,1,2021,380000,266400,646400,606700,2020-06-19,526000,2017-11-14,395700,121000,516700,395700,305400,701100,20:14:44,585
1149,311 GOOSE POND RD,411/  4/  /  / ,411,4,  ,002672/0796,335600,441600,24,1010,SINGLE FAM MDL01,RD,1,2021,165700,275900,441600,2666,2002-05-24,184000,1997-07-15,127500,130200,257700,127500,226300,353800,20:14:45,586
1150,333 GOOSE POND RD,411/  5/  /  / ,411,5,  ,  4445/ 491,385800,385800,7.4,1010,SINGLE FAM MDL01,RD,1,2021,195100,190700,385800,375000,2019-06-25,360000,2010-12-17,217700,164100,381800,217700,164100,381800,20:14:46,587
850,88 POST POND LN,408/  13/  /  / ,408,13,  , ,185700,185700,0.31,1013,SFR WATER  MDL-01,RD,1,2021,33500,152200,185700,0,,,,45400,99500,144900,45400,99500,144900,20:14:47,588
851,86 POST POND LN,408/  14/  /  / ,408,14,  , ,48000,158000,36,1060,AC LND IMP,RD,1,2021,1500,156500,158000,0,,,,1400,38000,39400,1400,140300,141700,20:14:47,589
852,108 POST POND LN,408/  15/  /  / ,408,15,  ,  3497/0908,174600,174600,0.2,1013,SFR WATER  MDL-01,RD,1,2021,35100,139500,174600,107000,2008-03-11,,,45000,85400,130400,45000,85400,130400,20:14:48,590
853,110 POST POND LN,408/  16/  /  / ,408,16,  ,  3231/0744,204500,204500,0.15,1013,SFR WATER  MDL-01,RD,1,2021,79000,125500,204500,0,2005-12-06,,,104000,64000,168000,104000,64000,168000,20:14:49,591
855,114 POST POND LN,408/  18/  /  / ,408,18,  ,  4576/ 498,171600,171600,0.25,1013,SFR WATER  MDL-01,RD,1,2021,42800,128800,171600,175000,2020-11-18,45000,1997-06-27,52900,77600,130500,52900,77600,130500,20:14:50,592
858,60 MASA MOREY LN,408/  21/  /  / ,408,21,  ,  4383/0491,8700,290600,38.5,6516,FARMR-6,RD,1,2021,0,290600,290600,400000,2018-08-23,,,0,8700,8700,0,266300,266300,20:14:51,593
860,42 ORFORD RD,408/  23/  /  / ,408,23,  ,  3651/0923,7000,422400,76.4,6234,HWUNR-4,RD,1,2021,0,422400,422400,0,2009-09-28,,,0,7000,7000,0,359700,359700,20:14:52,594
861,24 ORFORD RD,408/  24/  /  / ,408,24,  ,  1965/0976,342600,342600,1.6,1010,SINGLE FAM MDL01,RD,1,2021,203600,139000,342600,0,1992-05-11,19000,1972-06-12,217300,106000,323300,217300,106000,323300,20:14:53,595
862,16 ORFORD RD,408/  25/  /  / ,408,25,  ,  1557/0186,1048600,1048600,8.97,920C,NON PROFIT  MDL-94,RD,1,2021,714500,334100,1048600,0,,,,750000,273400,1023400,750000,273400,1023400,20:14:53,596
863,21 SPRING HILL LN,408/  26/  /  / ,408,26,  ,  2253/ 229,300,165600,8.84,6335,OTUNR-5,RD,1,2021,0,165600,165600,835000,1997-05-30,10000,1997-01-31,0,300,300,0,123700,123700,20:14:54,597
864,24 SPRING HILL LN,408/  27/  /  / ,408,27,  ,  2253/ 229,300,156600,8.74,6335,OTUNR-5,LCD,1,2021,0,156600,156600,835000,1997-05-30,10000,1997-01-31,0,300,300,0,115500,115500,20:14:55,598
865,60 SPRING HILL LN,408/  28/  /  / ,408,28,  ,  2253/ 229,1142000,1281600,43.79,1010,SINGLE FAM MDL01,RD,1,2021,913800,367800,1281600,835000,1997-05-30,100000,1989-10-12,722900,360000,1082900,722900,486600,1209500,20:14:58,599
867,60 ROCKY HILL LN,408/  29/  /  / ,408,29,  ,  3826/0809,1697000,1873500,42.5,1090,MULTI HSES,RD,3,2021,1064900,808600,1873500,1500000,2011-10-13,925048,1991-08-14,1013800,592200,1606000,1013800,752400,1766200,20:14:59,600
868,45 DORCHESTER RD,408/  30/  /  / ,408,30,  ,  3522/0112,491800,583600,25.95,1010,SINGLE FAM MDL01,LCD,1,2021,314000,269600,583600,595000,2008-05-30,240000,1986-06-10,306200,141600,447800,306200,224700,530900,20:14:59,601
869,53 DORCHESTER RD,408/  31/  /  / ,408,31,  ,  4662/ 861,365300,365300,4.29,1010,SINGLE FAM MDL01,LCD,1,2021,209700,155600,365300,345000,2021-08-27,4000,1987-12-29,163800,126000,289800,163800,126000,289800,20:15:00,602
871,61 DORCHESTER RD,408/  33/  /  / ,408,33,  ,  4199/0453,548600,548600,7.7,1010,SINGLE FAM MDL01,RD,1,2021,367100,181500,548600,0,2016-04-13,55895,1989-12-06,313200,182700,495900,313200,182700,495900,20:15:01,603
872,63 DORCHESTER RD,408/  34/  /  / ,408,34,  ,  2090/0463,600600,687200,20.2,1090,MULTI HSES,RD,2,2021,397900,289300,687200,240000,1994-05-10,40000,1987-12-22,411800,141500,553300,411800,220100,631900,20:15:02,604
873,30 CITADEL LN,408/  35/  /  / ,408,35,  ,  4253/0813,841100,1313300,141,1090,MULTI HSES,RD,3,2021,525300,788000,1313300,825000,2017-01-19,,,504500,320300,824800,504500,749800,1254300,20:15:03,605
874,18 CITADEL LN,408/  36/  /  / ,408,36,  ,  4593/  84,446700,446700,9.4,1010,SINGLE FAM MDL01,RD,1,2021,146500,300200,446700,0,2021-01-11,394000,2019-07-24,117400,287800,405200,117400,287800,405200,20:15:04,606
876,57 FRANKLIN HILL RD,408/  38/  /  / ,408,38,  ,  4406/03301,451400,540400,16.85,1010,SINGLE FAM MDL01,RD,1,2021,187900,352500,540400,425000,2018-12-11,,,157300,247200,404500,157300,327700,485000,20:15:05,607
878,83 FRANKLIN HILL RD,408/  40/  /  / ,408,40,  ,  4526/ 612,662000,791700,16,1010,SINGLE FAM MDL01,RD,1,2021,325900,465800,791700,500000,2020-06-11,285000,1996-07-18,294700,221600,516300,294700,339300,634000,20:15:06,608
879,7 HORTON LN,408/  41/  /  / ,408,41,  ,  1090/0175,348000,401600,14.9,1010,SINGLE FAM MDL01,RD,1,2021,183200,218400,401600,0,,,,167000,130600,297600,167000,179100,346100,20:15:07,609
880,11 HORTON LN,408/  42/  /  / ,408,42,  ,  4217/0999,566000,608700,11.69,1010,SINGLE FAM MDL01,,1,2021,384400,224300,608700,0,2016-06-29,170000,2014-12-30,345800,160000,505800,345800,198700,544500,20:15:08,610
100265,207 ORFORD RD,407/  53/  2000/  / ,407,53,2000,  4385/0342,635000,635000,6.87,1010,SINGLE FAM MDL01,,1,2021,431900,203100,635000,520000,2018-08-30,115000,2004-04-29,345400,170500,515900,345400,170500,515900,20:15:09,611
100302,54 BAKER HILL RD,409/  81/  /  / ,409,81,  ,  3719/0681,469900,469900,4.13,1010,SINGLE FAM MDL01,SFR,1,2021,263600,206300,469900,379000,2010-07-30,62000,1993-05-17,221900,159500,381400,221900,159500,381400,20:15:09,612
959,173 DORCHESTER RD,409/  12/  2000/  / ,409,12,2000,  3700/0590,341700,341700,0.34,1010,SINGLE FAM MDL01,LCD,1,2021,229100,112600,341700,120000,2010-05-12,12381,1993-08-17,201500,106300,307800,201500,106300,307800,20:15:10,613
326,188 DARTMOUTH COLLEGE HY,402/  32/  /  / ,402,32,  ,002827/0527,507900,507900,2.26,1090,MULTI HSES,,2,2021,327800,180100,507900,474000,2003-05-29,248400,2002-10-03,338700,138200,476900,338700,138200,476900,20:15:11,614
327,180 DARTMOUTH COLLEGE HY,402/  33/  /  / ,402,33,  ,  4283/0905,397600,397600,4.3,1010,SINGLE FAM MDL01,RD,1,2021,244400,153200,397600,105000,2017-05-15,110000,2014-03-28,166900,103600,270500,166900,103600,270500,20:15:12,615
328,174 DARTMOUTH COLLEGE HY,402/  34/  /  / ,402,34,  ,  4519/0079,339800,339800,2.9,1010,SINGLE FAM MDL01,RD,2,2021,178800,161000,339800,0,2020-05-13,369000,2018-11-21,201300,124200,325500,201300,124200,325500,20:15:13,616
329,166 DARTMOUTH COLLEGE HY,402/  35/  /  / ,402,35,  ,  3489/0943,224000,224000,0.47,1010,SINGLE FAM MDL01,RD,1,2021,130800,93200,224000,200000,2008-02-08,125000,2006-12-07,105000,83900,188900,105000,83900,188900,20:15:14,617
330,156 DARTMOUTH COLLEGE HY,402/  36/  /  / ,402,36,  ,  1750/ 617,362000,429200,13.9,1010,SINGLE FAM MDL01,,1,2021,228000,201200,429200,48839,1988-07-15,,,176300,100700,277000,176300,161800,338100,20:15:15,618
331,150 DARTMOUTH COLLEGE HY,402/  37/  /  / ,402,37,  ,  2976/0847,194300,194300,1.5,1010,SINGLE FAM MDL01,RD,1,2021,62500,131800,194300,0,2004-04-05,10000,2004-03-01,75800,95300,171100,75800,95300,171100,20:15:15,619
333,39 SHOESTRAP RD (OLD DUMP),402/  39/  /  / ,402,39,  , ,15700,15700,1.8,9035,TOWN-PROP,RD,1,2021,0,15700,15700,0,,,,0,12100,12100,0,12100,12100,20:15:16,620
1151,349 GOOSE POND RD,411/  6/  /  / ,411,6,  ,  1448/0590,347500,347500,135,9000,US GOVT,RD,1,2021,0,347500,347500,0,,,,0,299700,299700,0,299700,299700,20:15:17,621
1152,371 GOOSE POND RD,411/  7/  /  / ,411,7,  , ,4800,311600,59.98,6334,OTUNR-4,RD,1,2021,0,311600,311600,0,,,,0,4800,4800,0,260400,260400,20:15:18,622
1154,354 GOOSE POND RD,411/  9/  /  / ,411,9,  ,  1418/0867,100400,100400,5.4,9000,US GOVT,RD,1,2021,0,100400,100400,0,,,,0,79000,79000,0,79000,79000,20:15:19,623
1155,334 GOOSE POND RD,411/  10/  /  / ,411,10,  ,  3765/0365,1100,217300,17,6235,HWUNR-5,RD,1,2021,0,217300,217300,0,2011-01-06,,,0,1100,1100,0,168200,168200,20:15:20,624
1156,322 GOOSE POND RD,411/  11/  /  / ,411,11,  ,  4123/0285,492800,564700,15,1010,SINGLE FAM MDL01,RD,1,2021,343100,221600,564700,0,2015-04-27,20500,1977-09-23,333100,114000,447100,333100,179300,512400,20:15:21,625
1157,310 GOOSE POND RD,411/  12/  /  / ,411,12,  ,  2549/0310,202200,255400,11.3,1010,SINGLE FAM MDL01,RD,1,2021,77200,178200,255400,0,2001-05-29,,,87100,95500,182600,87100,143800,230900,20:15:22,626
1158,290 GOOSE POND RD,411/  13/  /  / ,411,13,  ,  4182/ 565,4400,304500,37,6135,WPUNR-5,RD,1,2021,0,304500,304500,325000,2016-01-06,200000,2006-06-20,0,4400,4400,0,249000,249000,20:15:22,627
1163,330 GRAFTON TK,412/  2/  /  / ,412,2,  ,  4263/0357,3600,205000,55,6235,HWUNR-5,MFD,1,2021,0,205000,205000,0,2017-01-17,,,0,3600,3600,0,172600,172600,20:15:23,628
1164,280 GRAFTON TK,412/  3/  /  / ,412,3,  ,  3848/0046,102500,2792500,2076,6335,OTUNR-5,MFD,1,2021,0,2792500,2792500,0,2011-12-30,2150000,2006-09-06,0,102500,102500,0,2526900,2526900,20:15:24,629
1166,107 GRAFTON TK,413/  2/  /  / ,413,2,  ,  2325/0588,337300,337300,7,1010,SINGLE FAM MDL01,ELD,1,2021,182400,154900,337300,85000,1998-07-01,,,191000,121100,312100,191000,121100,312100,20:15:25,630
1167,117 GRAFTON TK,413/  3/  /  / ,413,3,  ,  1459/0219,296600,296600,5.8,1010,SINGLE FAM MDL01,ELD,1,2021,154000,142600,296600,0,,,,132500,111500,244000,132500,111500,244000,20:15:26,631
1170,139 GRAFTON TK,413/  6/  /  / ,413,6,  ,  1661/ 695,433300,561400,27.3,1010,SINGLE FAM MDL01,ELD,1,2021,261600,299800,561400,100000,1987-04-16,,,274400,143000,417400,274400,259300,533700,20:15:27,632
1173,210 GRAFTON TPK,413/  9/  /  / ,413,9,  ,  1397/0757,182300,316600,66,1010,SINGLE FAM MDL01,ELD,1,2021,58600,258000,316600,0,,,,52300,45300,97600,52300,167000,219300,20:15:28,633
1177,21 TYLER HILL RD,413/  10/  /  / ,413,10,  ,  4068/ 0339,13700,324600,286,6232,HWUNR-2,MFD,1,2021,0,324600,324600,257467,2014-07-07,,,0,13700,13700,0,292700,292700,20:15:29,634
954,167 DORCHESTER RD,409/  10/  /  / ,409,10,  ,  3294/0105,290800,290800,0.82,1010,SINGLE FAM MDL01,,1,2021,134700,156100,290800,0,2006-06-08,120000,1996-09-13,128500,135400,263900,128500,135400,263900,20:15:30,635
955,169 DORCHESTER RD,409/  11/  /  / ,409,11,  ,  3566/0834,216000,216000,0.6,1010,SINGLE FAM MDL01,LCD,1,2021,91100,124900,216000,0,2008-11-21,100,1965-01-18,78700,94100,172800,78700,94100,172800,20:15:31,636
958,171 DORCHESTER RD,409/  12/  1000/  / ,409,12,1000,  3894/0396,420200,420200,0.45,1010,SINGLE FAM MDL01,LCD,1,2021,311600,108600,420200,390000,2012-06-26,160000,2010-04-30,254000,114300,368300,254000,114300,368300,20:15:32,637
782,37+51 PINNACLE RD,407/  96/  1100/  / ,407,96,1100,  2144/0358,1116800,1232100,43.1,1060,AC LND IMP,RD,2,2021,831100,401000,1232100,177000,1995-06-05,158000,1986-01-16,760400,308000,1068400,760400,412300,1172700,20:15:33,638
783,45 PINNACLE RD,407/  96/  1200/  / ,407,96,1200,  2173/0155,246900,246900,3.1,1010,SINGLE FAM MDL01,RD,1,2021,94200,152700,246900,130000,1995-12-13,125048,1992-07-01,117400,106300,223700,117400,106300,223700,20:15:34,639
784,39 PINNACLE RD,407/  96/  2000/  / ,407,96,2000,  4173/ 290,160600,160600,5.59,1060,AC LND IMP,RD,1,2021,11200,149400,160600,200000,2015-11-18,280000,1993-09-20,10400,140300,150700,10400,140300,150700,20:15:34,640
786,63 PINNACLE RD,407/  98/  /  / ,407,98,  ,  2612/0104,724200,867100,22,1010,SINGLE FAM MDL01,,2,2021,484200,382900,867100,2666,2001-12-14,170000,1988-08-22,419400,311500,730900,419400,379600,799000,20:15:35,641
788,75 PINNACLE RD,407/  100/  /  / ,407,100,  ,  4306/0019,292600,292600,5.1,1010,SINGLE FAM MDL01,RD,1,2021,136300,156300,292600,170000,2017-08-20,272533,2016-10-18,95300,122000,217300,95300,122000,217300,20:15:36,642
789,83 PINNACLE RD,407/  101/  /  / ,407,101,  ,  4397/0481,404100,496200,10.73,1010,SINGLE FAM MDL01,RD,1,2021,273500,222700,496200,425000,2018-10-26,84900,1986-04-16,194500,102000,296500,194500,185600,380100,20:15:37,643
792,91 PINNACLE RD,407/  102/  1000/  / ,407,102,1000,  4172/ 338,594300,594300,6.97,1010,SINGLE FAM MDL01,RD,1,2021,413000,181300,594300,0,2015-11-16,498000,2014-04-30,408600,137100,545700,408600,137100,545700,20:15:38,644
793,109 PINNACLE RD,407/  102/  2000/  / ,407,102,2000,002738/0560,2800,268100,37.78,6503,FARM-3,RD,1,2021,0,268100,268100,112533,2002-10-31,135800,1986-08-18,0,2800,2800,0,222500,222500,20:15:39,645
363,5 SLOAN LN,402/  65/  /  / ,402,65,  ,  4298/0564,519100,519100,0.66,1010,SINGLE FAM MDL01,RD,1,2021,391000,128100,519100,497266,2017-07-18,214000,2009-03-03,314800,108300,423100,314800,108300,423100,20:15:40,646
364,7 SLOAN LN,402/  66/  /  / ,402,66,  ,  1149/0325,212700,212700,0.33,1010,SINGLE FAM MDL01,RD,1,2021,114400,98300,212700,0,,,,83300,72900,156200,83300,72900,156200,20:15:41,647
365,19 SLOAN LN,402/  67/  /  / ,402,67,  ,  2294/0557,802300,1047800,48.48,1090,MULTI HSES,RD,2,2021,544900,502900,1047800,0,1998-01-16,225000,1981-06-05,538500,204500,743000,538500,426400,964900,20:15:42,648
368,8 SLOAN LN,402/  70/  /  / ,402,70,  ,  3529/0108,354600,354600,0.51,1010,SINGLE FAM MDL01,RD,1,2021,242900,111700,354600,357666,2008-06-18,340000,2002-05-15,238100,102400,340500,238100,102400,340500,20:15:43,649
369,264 RIVER RD,402/  71/  /  / ,402,71,  ,  2238/0380,718000,923000,45.73,1010,SINGLE FAM MDL01,RD,1,2021,477100,445900,923000,90000,1997-02-04,,,450900,244500,695400,450900,417800,868700,20:15:44,650
370,240 RIVER RD,402/  72/  /  / ,402,72,  ,  2364/0244,312000,312000,58,9200,NON PROFIT  MDL-00,RD,1,2021,0,312000,312000,175000,1998-09-23,4000,1996-11-11,0,255600,255600,0,255600,255600,20:15:45,651
371,234 RIVER RD,402/  73/  /  / ,402,73,  ,  4375/0574,509100,509100,2.18,1010,SINGLE FAM MDL01,RD,1,2021,342300,166800,509100,515000,2018-07-19,480000,2015-12-07,323100,154400,477500,323100,154400,477500,20:15:46,652
372,228 RIVER RD,402/  74/  1000/  / ,402,74,1000,  4290/0633,428600,428600,9.8,1010,SINGLE FAM MDL01,RD,1,2021,219900,208700,428600,0,2017-06-15,407000,2009-10-15,209400,199900,409300,209400,199900,409300,20:15:47,653
375,202 RIVER RD,402/  77/  /  / ,402,77,  ,  4508/ 207,303100,303100,7.06,1300,RES ACLNDV,RD,1,2021,0,303100,303100,349000,2020-03-27,100000,2006-08-10,0,156600,156600,0,156600,156600,20:15:48,654
376,192 RIVER RD,402/  78/  /  / ,402,78,  ,  2998/0599,551200,714100,50.5,1010,SINGLE FAM MDL01,RD,1,2021,387900,326200,714100,0,2004-05-06,,,330500,144100,474600,330500,292100,622600,20:15:49,655
966,185 DORCHESTER RD,409/  19/  /  / ,409,19,  ,  3662/0521,542200,542200,0.87,1010,SINGLE FAM MDL01,LCD,1,2021,376200,166000,542200,0,2009-11-12,261500,1997-07-14,330800,144000,474800,330800,144000,474800,20:15:49,656
967,187 DORCHESTER RD,409/  20/  /  / ,409,20,  ,  3925/0175,640600,640600,1.5,1010,SINGLE FAM MDL01,LCD,1,2021,467700,172900,640600,173000,2012-10-18,,,438500,152000,590500,438500,152000,590500,20:15:50,657
968,11 ACORN HILL RD,409/  21/  /  / ,409,21,  ,  4027/0679,369900,510200,27,1010,SINGLE FAM MDL01,RD,1,2021,207300,302900,510200,0,2013-11-26,132000,2008-11-12,168400,126100,294500,168400,253200,421600,20:15:51,658
971,22 POUT POND LN,409/  24/  /  / ,409,24,  ,  4647/ 864,380500,380500,6.9,1010,SINGLE FAM MDL01,RD,1,2021,207900,172600,380500,525000,2021-06-08,345000,2011-01-12,191500,136900,328400,191500,136900,328400,20:15:52,659
972,38 ACORN HILL RD,409/  25/  /  / ,409,25,  ,  1737/0625,1600,158100,12.5,6135,WPUNR-5,RD,1,2021,0,158100,158100,4000,1970-05-15,,,0,1600,1600,0,122200,122200,20:15:53,660
973,34 ACORN HILL RD,409/  26/  /  / ,409,26,  ,  1729/ 945,397100,397100,2.9,1010,SINGLE FAM MDL01,RD,1,2021,245500,151600,397100,19200,1988-03-24,,,246700,116700,363400,246700,116700,363400,20:15:54,661
974,26 ACORN HILL RD,409/  27/  /  / ,409,27,  ,  4522/ 862,644500,729100,17.8,1010,SINGLE FAM MDL01,RD,1,2021,463100,266000,729100,735000,2020-05-27,650000,2015-03-04,395700,183300,579000,395700,260100,655800,20:15:55,662
975,28 ACORN HILL RD,409/  28/  /  / ,409,28,  ,  4299/0778,900,221300,19.9,6324,OTUN-4,RD,1,2021,0,221300,221300,0,2017-07-25,150000,1997-09-29,0,900,900,0,202400,202400,20:15:56,663
976,20 ACORN HILL RD,409/  29/  /  / ,409,29,  ,  4164/ 283,474500,474500,9.8,1010,SINGLE FAM MDL01,RD,1,2021,262700,211800,474500,0,2015-10-08,80000,1994-07-29,198300,167700,366000,198300,167700,366000,20:15:56,664
979,197 DORCHESTER RD,409/  32/  /  / ,409,32,  ,  3130/0854,225000,225000,1.4,1010,SINGLE FAM MDL01,RD,1,2021,94700,130300,225000,0,2005-03-14,,,87600,98700,186300,87600,98700,186300,20:15:57,665
981,201 DORCHESTER RD,409/  34/  /  / ,409,34,  ,  3664/0756,399800,399800,1.1,1010,SINGLE FAM MDL01,,1,2021,270900,128900,399800,339500,2009-11-23,310000,2008-02-21,226600,97500,324100,226600,97500,324100,20:15:58,666
982,215 DORCHESTER RD,409/  35/  /  / ,409,35,  ,  3228/0159,249400,249400,3.2,1010,SINGLE FAM MDL01,RD,1,2021,112400,137000,249400,0,2005-12-07,,,72500,104800,177300,72500,104800,177300,20:15:59,667
984,227 DORCHESTER RD,409/  37/  /  / ,409,37,  , ,209100,209100,2,1010,SINGLE FAM MDL01,RD,1,2021,90800,118300,209100,0,,,,78500,90100,168600,78500,90100,168600,20:16:00,668
986,1 FLINT HILL RD,409/  39/  /  / ,409,39,  ,  3419/0258,246600,246600,1.7,1010,SINGLE FAM MDL01,RD,1,2021,107000,139600,246600,0,2007-06-19,88500,1994-10-03,122600,96500,219100,122600,96500,219100,20:16:01,669
987,232 DORCHESTER RD,409/  40/  /  / ,409,40,  ,  4358/0113,422900,670300,80.7,1010,SINGLE FAM MDL01,RD,1,2021,258800,411500,670300,0,2018-05-04,150000,1996-07-29,231400,117700,349100,231400,341500,572900,20:16:02,670
990,224 DORCHESTER RD,409/  43/  /  / ,409,43,  ,  3101/0786,5200,16100,10.9,1320,RES ACLNUD,MFD,1,2021,4100,12000,16100,14000,2005-01-26,,,3800,1100,4900,3800,10900,14700,20:16:02,671
991,228 DORCHESTER RD,409/  44/  /  / ,409,44,  ,  1034/0242,208800,208800,1.56,1010,SINGLE FAM MDL01,RD,1,2021,77800,131000,208800,0,,,,73200,99300,172500,73200,99300,172500,20:16:03,672
992,216 DORCHESTER RD,409/  45/  /  / ,409,45,  ,  3848/0046,13500,680300,207.89,6135,WPUNR-5,RD,1,2021,0,680300,680300,0,2011-12-30,600000,2006-03-01,0,13500,13500,0,599100,599100,20:16:04,673
993,202 DORCHESTER RD,409/  46/  /  / ,409,46,  ,  3971/0540,346600,346600,2.69,1010,SINGLE FAM MDL01,RD,1,2021,210700,135900,346600,0,2014-04-18,,,194900,99100,294000,194900,99100,294000,20:16:05,674
994,196 DORCHESTER RD,409/  47/  /  / ,409,47,  ,  4101/ 262,316300,316300,5.1,1010,SINGLE FAM MDL01,RD,1,2021,145200,171100,316300,0,2014-11-10,42500,1997-07-16,121500,122900,244400,121500,122900,244400,20:16:06,675
995,188 DORCHESTER RD,409/  48/  /  / ,409,48,  ,  3762/0274,255300,255300,0.54,1010,SINGLE FAM MDL01,LCD,1,2021,165900,89400,255300,143000,2010-12-27,65048,1992-06-03,111000,49900,160900,111000,49900,160900,20:16:06,676
996,182 DORCHESTER RD,409/  49/  /  / ,409,49,  ,  1824/  73,522800,522800,2.1,101,Single Fam,LCD,1,2021,336100,186700,522800,225053,1989-09-22,125000,1987-06-03,310800,163900,474700,310800,163900,474700,20:16:07,677
997,180 DORCHESTER RD,409/  50/  /  / ,409,50,  ,  4419/0308,373200,373200,1.1,1010,SINGLE FAM MDL01,LCD,1,2021,212500,160700,373200,0,2019-03-04,400000,2018-08-20,208500,141500,350000,208500,141500,350000,20:16:08,678
998,11 BAKER HILL RD,409/  51/  /  / ,409,51,  ,  2157/0881,654800,822100,32.01,1010,SINGLE FAM MDL01,RD,1,2021,442600,379500,822100,230000,1995-09-06,,,435600,162900,598500,435600,314800,750400,20:16:09,679
1002,59 BAKER HILL RD,409/  53/  1000/  / ,409,53,1000,  3765/0363,4800,141700,58,6225,HWUN-5,RD,1,2021,0,141700,141700,0,2011-01-08,,,0,4800,4800,0,125300,125300,20:16:10,680
1003,57 BAKER HILL RD,409/  53/  2000/  / ,409,53,2000,  2612/0667,346800,541300,30,1010,SINGLE FAM MDL01,RD,1,2021,179900,361400,541300,305000,2001-12-12,4000,1996-09-13,198500,137300,335800,198500,254300,452800,20:16:11,681
1004,63 BAKER HILL RD,409/  54/  /  / ,409,54,  ,  3445/0201,546100,546100,7.2,1010,SINGLE FAM MDL01,RD,1,2021,370900,175200,546100,480000,2007-08-31,90000,1995-04-28,289200,166000,455200,289200,166000,455200,20:16:12,682
1005,67 + 69 BAKER HILL RD,409/  55/  /  / ,409,55,  ,  1967/0936,533100,533100,2.2,1090,MULTI HSES,RD,2,2021,348300,184800,533100,180000,1992-05-15,165000,1990-07-23,303600,124000,427600,303600,124000,427600,20:16:13,683
1006,71 BAKER HILL RD,409/  56/  /  / ,409,56,  ,  4212/0375,271800,271800,0.97,1010,SINGLE FAM MDL01,RD,1,2021,131500,140300,271800,260000,2016-06-06,242000,2008-08-29,113800,106500,220300,113800,106500,220300,20:16:15,684
1009,95 BAKER HILL RD,409/  57/  /  / ,409,57,  ,  3869/0211,10800,366700,75,6514,FARMR-4,RD,1,2021,0,366700,366700,0,2012-03-19,325933,2005-03-21,0,10800,10800,0,306500,306500,20:16:15,685
102692,62 POUT POND LN,414/  9/  2000/  / ,414,9,2000,  4404/0053,814200,873600,12.2,1010,SINGLE FAM MDL01,RD,1,2021,645300,228300,873600,0,2018-11-30,,,522900,148200,671100,522900,201600,724500,20:16:16,686
1015,127 BAKER HILL RD,409/  60/  /  / ,409,60,  , ,178600,178600,5.1,1010,SINGLE FAM MDL01,RD,1,2021,56500,122100,178600,0,,,,49200,95200,144400,49200,95200,144400,20:16:17,687
1016,124 BAKER HILL RD,409/  61/  /  / ,409,61,  , ,277700,277700,2,1010,SINGLE FAM MDL01,RD,1,2021,122600,155100,277700,0,,,,111500,118800,230300,111500,118800,230300,20:16:18,688
1018,25 ISAAC PERKINS RD,409/  63/  /  / ,409,63,  ,  3820/0308,138000,235200,12.11,1010,SINGLE FAM MDL01,RD,1,2021,43400,191800,235200,383000,2011-09-09,,,39600,81900,121500,39600,161500,201100,20:16:19,689
1020,47 ISAAC PERKINS RD,409/  65/  /  / ,409,65,  , ,250200,250200,4.1,1010,SINGLE FAM MDL01,RD,1,2021,81200,169000,250200,0,,,,102200,131400,233600,102200,131400,233600,20:16:20,690
1023,54 ISAAC PERKINS RD,409/  68/  /  / ,409,68,  ,  4596/ 706,356200,356200,5.9,1040,TWO FAMILY,RD,1,2021,160500,195700,356200,0,2021-01-25,,,139700,158800,298500,139700,158800,298500,20:16:20,691
1024,48 ISAAC PERKINS RD,409/  69/  /  / ,409,69,  , ,291300,291300,2.1,1010,SINGLE FAM MDL01,RD,1,2021,142900,148400,291300,0,,,,121200,102400,223600,121200,102400,223600,20:16:22,692
1025,40 ISAAC PERKINS RD,409/  70/  /  / ,409,70,  ,  3244/0204,479500,479500,9.1,1010,SINGLE FAM MDL01,RD,1,2021,277500,202000,479500,0,2006-01-26,,,201800,189300,391100,201800,189300,391100,20:16:22,693
1026,34 ISAAC PERKINS RD,409/  71/  /  / ,409,71,  ,  3820/0308,437500,526200,16.9,1010,SINGLE FAM MDL01,RD,1,2021,261400,264800,526200,383000,2011-09-09,,,248000,138200,386200,248000,218500,466500,20:16:23,694
1027,160 EAST ST,409/  72/  /  / ,409,72,  ,  4519/ 348,19100,401100,241,6224,HWUN-4,RD,1,2021,0,401100,401100,248300,2020-05-14,,,0,19100,19100,0,354800,354800,20:16:24,695
1028,65 ALDEN LN,409/  73/  /  / ,409,73,  ,  3964/0537,12200,12200,6,1320,RES ACLNUD,RD,1,2021,0,12200,12200,10000,2013-03-22,,,0,10500,10500,0,10500,10500,20:16:25,696
1030,16 ISAAC PERKINS RD,409/  75/  /  / ,409,75,  ,  4530/ 297,633200,723000,13,1010,SINGLE FAM MDL01,RD,1,2021,368900,354100,723000,792500,2020-06-24,720000,2017-09-18,320700,229000,549700,320700,310300,631000,20:16:26,697
1031,10 ISAAC PERKINS-1 ALDEN  RD,409/  76/  /  / ,409,76,  ,  1303/0368,286700,321700,11.8,1010,SINGLE FAM MDL01,RD,1,2021,145000,176700,321700,800,1977-02-21,1800,1975-03-09,114500,113400,227900,114500,145200,259700,20:16:27,698
1033,60 BAKER HILL RD,409/  78/  /  / ,409,78,  ,  1411/0076,477700,605100,32.5,1010,SINGLE FAM MDL01,RD,1,2021,298200,306900,605100,0,1980-11-26,22000,1977-07-29,229300,139800,369100,229300,255300,484600,20:16:28,699
1034,62 BAKER HILL RD,409/  79/  /  / ,409,79,  ,  3560/0357,33700,121000,37,1060,AC LND IMP,RD,1,2021,17100,103900,121000,75000,2008-10-24,,,15300,13100,28400,15300,92400,107700,20:16:28,700
1035,56 BAKER HILL RD,409/  80/  /  / ,409,80,  ,  3465/0963,414200,414200,5.37,1010,SINGLE FAM MDL01,RD,1,2021,162400,251800,414200,0,2007-11-06,172000,1997-05-14,140800,195200,336000,140800,195200,336000,20:16:30,701
1037,48 BAKER HILL RD,409/  82/  /  / ,409,82,  ,  1098/ 353,279800,279800,10.5,1010,SINGLE FAM MDL01,RD,1,2021,53700,226100,279800,0,,,,29400,226000,255400,29400,226000,255400,20:16:31,702
1039,12 BAKER HILL RD,409/  84/  /  / ,409,84,  ,  4612/ 972,113300,422400,81.21,1300,RES ACLNDV,RD,1,2021,0,422400,422400,400000,2021-03-19,687000,2006-09-12,0,108100,108100,0,407700,407700,20:16:32,703
1040,2 BAKER HILL RD,409/  85/  /  / ,409,85,  ,  2353/0323,498800,498800,0.53,1010,SINGLE FAM MDL01,LCD,1,2021,355700,143100,498800,4000,1998-10-06,185000,1988-06-29,332600,144300,476900,332600,144300,476900,20:16:33,704
1041,176 DORCHESTER RD,409/  86/  /  / ,409,86,  ,  3198/0479,496300,496300,0.67,1010,SINGLE FAM MDL01,LCD,1,2021,348600,147700,496300,453000,2005-09-28,4000,1997-06-07,301900,152300,454200,301900,152300,454200,20:16:34,705
1042,168 DORCHESTER RD,409/  87/  /  / ,409,87,  ,  3726/0303,398600,398600,0.71,1010,SINGLE FAM MDL01,,1,2021,245800,152800,398600,340000,2010-08-27,303000,2001-07-19,228600,139800,368400,228600,139800,368400,20:16:34,706
1043,166 DORCHESTER RD,409/  88/  /  / ,409,88,  ,  2123/0335,226100,226100,0.22,1010,SINGLE FAM MDL01,LCD,1,2021,125600,100500,226100,20000,1994-12-19,,,122000,80700,202700,122000,80700,202700,20:16:35,707
1045,162 DORCHESTER RD,409/  90/  /  / ,409,90,  ,  1769/ 690,173600,173600,0.48,1010,SINGLE FAM MDL01,LCD,1,2021,68200,105400,173600,0,1995-10-05,37400,1988-10-13,65600,96400,162000,65600,96400,162000,20:16:36,708
1048,130 DORCHESTER RD,409/  93/  /  / ,409,93,  ,  1298/0865,4400,4400,0.34,9010,STATE NH,RD,1,2021,0,4400,4400,0,,,,0,4100,4100,0,4100,4100,20:16:38,709
1423,1 LAMBERT RG,419/  1/  /  / ,419,1,  , ,342200,342200,777.62,9000,US GOVT,MFD,1,2021,0,342200,342200,0,,,,0,311000,311000,0,311000,311000,20:16:39,710
1435,7 LAMBERT RG,419/  7/  /  / ,419,7,  ,003095/0137,88300,88300,114.7,9000,US GOVT,MFD,1,2021,0,88300,88300,47950,2004-12-16,33533,2004-04-01,0,80300,80300,0,80300,80300,20:16:40,711
1436,8 LAMBERT RG,419/  8/  /  / ,419,8,  ,  3102/0731,57100,57100,64.85,9000,US GOVT,MFD,1,2021,0,57100,57100,27000,2005-01-15,5000,1987-04-10,0,51900,51900,0,51900,51900,20:16:41,712
1437,545 DORCHESTER RD,419/  9/  /  / ,419,9,  ,  2256/0048,183500,183500,89,9000,US GOVT,MFD,1,2021,0,183500,183500,25000,1997-06-17,,,0,166900,166900,0,166900,166900,20:16:42,713
1438,509 DORCHESTER RD,420/  1/  /  / ,420,1,  ,  2256/0067,177200,177200,63,9000,US GOVT,ELD,1,2021,0,177200,177200,0,1997-01-06,4000,1996-06-04,0,159300,159300,0,159300,159300,20:16:42,714
1439,511 DORCHESTER RD,420/  2/  /  / ,420,2,  ,  3095/0137,85000,85000,110.35,9000,US GOVT,MFD,1,2021,0,85000,85000,47950,2004-12-16,1770,1998-12-10,0,77200,77200,0,77200,77200,20:16:43,715
1440,535 DORCHESTER RD,420/  3/  /  / ,420,3,  ,  2121/0393,404400,404400,919,9000,US GOVT,MFD,1,2021,0,404400,404400,2000,1994-12-02,454095,1993-01-15,0,367600,367600,0,367600,367600,20:16:44,716
1441,525 DORCHESTER RD,420/  4/  /  / ,420,4,  ,  3601/0644,7500,7500,6.8,9000,US GOVT,MFD,1,2021,0,7500,7500,38000,2009-04-22,,,0,6800,6800,0,6800,6800,20:16:45,717
1442,517 DORCHESTER RD (BEALE CEM,420/  5/  /  / ,420,5,  , ,10900,10900,0.57,9035,TOWN-PROP,ELD,1,2021,0,10900,10900,0,,,,0,9200,9200,0,9200,9200,20:16:46,718
1443,539 DORCHESTER RD,420/  6/  /  / ,420,6,  ,  2256/0875,5900,589400,124,6215,HWMR-5,ELD,1,2021,0,589400,589400,3996000,1997-06-20,,,0,5900,5900,0,512400,512400,20:16:47,719
1446,581 DORCHESTER RD,420/  7/  1000/  / ,420,7,1000,  3479/0620,11000,630500,243,6104,WPM-4,ELD,1,2021,0,630500,630500,190000,2007-12-27,250000,1988-10-18,0,11000,11000,0,595200,595200,20:16:47,720
1447,601 DORCHESTER RD,420/  7/  2000/  / ,420,7,2000,  4307/0326,2700,270000,40.2,1060,AC LND IMP,ELD,1,2021,200,269800,270000,215000,2017-08-28,85048,1990-11-15,200,2500,2700,200,230100,230300,20:16:49,721
1449,623 DORCHESTER RD,420/  9/  /  / ,420,9,  ,  4533/ 326,335600,335600,0.87,1013,SFR WATER  MDL-01,ELD,1,2021,60700,274900,335600,333000,2020-07-02,2000,1958-08-14,79000,179900,258900,79000,179900,258900,20:16:49,722
1450,625 DORCHESTER RD,420/  10/  /  / ,420,10,  ,  4023/ 0683,92100,92100,0.62,1060,AC LND IMP,ELD,1,2021,18900,73200,92100,0,2013-11-06,9500,1981-10-14,16600,64000,80600,16600,64000,80600,20:16:50,723
1451,629 DORCHESTER RD,420/  11/  /  / ,420,11,  ,  4023/0682,254600,254600,0.17,1013,SFR WATER  MDL-01,ELD,1,2021,109100,145500,254600,0,2013-11-06,20000,1978-07-28,86700,118800,205500,86700,118800,205500,20:16:51,724
1455,638 DORCHESTER RD,420/  15/  /  / ,420,15,  ,  2974/0984,450100,450100,1,1013,SFR WATER  MDL-01,ELD,1,2021,219200,230900,450100,0,2004-04-02,285000,2002-07-19,208300,142200,350500,208300,142200,350500,20:16:52,725
1456,634 DORCHESTER RD,420/  16/  /  / ,420,16,  ,  4129/0469,208500,208500,0.88,1013,SFR WATER  MDL-01,ELD,1,2021,34800,173700,208500,130000,2015-05-21,2666,2001-08-09,27700,110900,138600,27700,110900,138600,20:16:54,726
1457,632 DORCHESTER RD,420/  17/  /  / ,420,17,  ,  1930/0145,281100,281100,2.06,1013,SFR WATER  MDL-01,ELD,1,2021,122000,159100,281100,155048,1991-08-30,100,1977-01-06,123200,132400,255600,123200,132400,255600,20:16:55,727
101224,289 GOOSE POND RD,411/  1/  /  / ,411,1,  ,  4196/0669,658900,734100,17.27,1080,SFR/ACC UNIT,RD,1,2021,484500,249600,734100,0,2016-04-01,195533,2003-11-10,389900,158900,548800,389900,227100,617000,20:16:55,728
101242,34 POUT POND LN,409/  23/  2000/  / ,409,23,2000,  3991/0207,909300,909300,8.08,1010,SINGLE FAM MDL01,RD,1,2021,660000,249300,909300,740000,2013-06-27,112533,2001-05-02,533100,220700,753800,533100,220700,753800,20:16:56,729
1464,552 DORCHESTER RD,420/  24/  /  / ,420,24,  ,O-2000/  61,1300,138700,33,6232,HWUNR-2,MFD,1,2021,0,138700,138700,0,2000-10-27,,,0,1300,1300,0,113000,113000,20:16:57,730
1466,550 DORCHESTER RD,420/  26/  /  / ,420,26,  ,  0406/0167,3600,368800,79,6335,OTUNR-5,ELD,1,2021,0,368800,368800,0,,,,0,3600,3600,0,315900,315900,20:16:58,731
1468,500 DORCHESTER RD,420/  28/  /  / ,420,28,  ,  2318/ 676,538300,647600,30.5,1040,TWO FAMILY,ELD,1,2021,280800,366800,647600,20000,1998-05-29,4000,1997-06-04,232700,186000,418700,232700,285200,517900,20:17:01,732
888,18 HORTON LN,408/  47/  2000/  / ,408,47,2000,  3876/0442,800,160200,12.7,6124,WPUN-4,RD,1,2021,0,160200,160200,0,2012-04-26,185000,2003-12-02,0,800,800,0,163200,163200,20:17:02,733
891,129 FRANKLIN HILL RD,408/  48/  2000/  / ,408,48,2000,  4621/ 264,516800,596500,12.75,1010,SINGLE FAM MDL01,RD,1,2021,403600,192900,596500,617000,2021-04-15,525000,2013-03-14,334900,113000,447900,334900,178600,513500,20:17:03,734
892,145 FRANKLIN HILL RD,408/  48/  1000/  / ,408,48,1000,  4585/ 612,155100,554000,44.4,6515,FARMR-5,RD,1,2021,0,554000,554000,600000,2020-12-16,100,1974-06-10,0,5100,5100,0,310700,310700,20:17:04,735
897,3 HARDSCRABBLE LN,408/  52/  /  / ,408,52,  ,  4178/0830,6100,138700,14.4,6506,FARM-6,RD,1,2021,0,138700,138700,0,2015-12-21,363533,2015-08-07,0,6100,6100,0,359800,359800,20:17:05,736
101442,44 FRANKLIN HILL RD,408/  75/  3000/  / ,408,75,3000,  4132/0455,93300,403900,36,1060,AC LND IMP,RD,1,2021,3500,400400,403900,260000,2015-06-04,110000,2007-10-09,3300,32100,35400,3300,274600,277900,20:17:06,737
101462,230 RIVER RD,402/  74/  2000/  / ,402,74,2000,  3242/0831,1117900,1117900,6.6,1010,SINGLE FAM MDL01,RD,1,2021,926800,191100,1117900,170000,2006-01-20,387000,2005-01-11,840900,176500,1017400,840900,176500,1017400,20:17:07,738
101483,192 GOOSE POND RD,410/  71/  /  / ,410,71,  ,  3922/0732,144600,144600,11.4,1300,RES ACLNDV,RD,1,2021,200,144400,144600,110000,2012-10-09,1000,1973-02-08,0,119900,119900,0,119900,119900,20:17:08,739
900,18 + 20 HARDSCRABBLE LN,408/  55/  /  / ,408,55,  ,  4183/ 665,1004200,1239000,32.5,1090,MULTI HSES,RD,2,2021,563900,675100,1239000,0,2016-01-14,,,517700,391600,909300,517700,604500,1122200,20:17:09,740
901,172 ACORN HILL RD,408/  56/  /  / ,408,56,  ,  2008/0171,292300,292300,0.94,1010,SINGLE FAM MDL01,RD,1,2021,114200,178100,292300,0,1993-01-06,,,96400,109300,205700,96400,109300,205700,20:17:10,741
907,112 ACORN HILL RD,408/  57/  1000/  / ,408,57,1000,  2263/0986,700,375900,10.51,6233,HWUNR-3,RD,1,2021,0,375900,375900,235000,1997-08-01,350000,1993-12-03,0,700,700,0,240800,240800,20:17:10,742
908,118 ACORN HILL RD,408/  57/  2000/  / ,408,57,2000,  2263/0986,3300,428000,13.26,6514,FARMR-4,RD,1,2021,0,428000,428000,235000,1997-08-01,350000,1993-12-03,0,3300,3300,0,313900,313900,20:17:11,743
909,146 ACORN HILL RD,408/  57/  3000/  / ,408,57,3000,  3940/0992,1902400,2449500,110.62,1010,SINGLE FAM MDL01,RD,1,2021,1264700,1184800,2449500,3315000,2012-12-18,3000000,2010-01-29,1308200,483300,1791500,1308200,979200,2287400,20:17:12,744
910,160 ACORN HILL RD,408/  57/  4000/  / ,408,57,4000,  3940/0992,738600,891200,22.08,1010,SINGLE FAM MDL01,RD,1,2021,487700,403500,891200,3315000,2012-12-18,3000000,2010-01-29,411800,244200,656000,411800,382200,794000,20:17:13,745
911,82 ACORN HILL RD,408/  58/  /  / ,408,58,  ,  3668/0014,738000,1273200,103.1,1010,SINGLE FAM MDL01,,1,2021,420600,852600,1273200,152333,2009-12-10,340000,1990-12-21,382300,310000,692300,382300,795200,1177500,20:17:14,746
912,70 ACORN HILL RD,408/  59/  /  / ,408,59,  ,  4028/0759,3700,81400,10.07,6504,FARM-4,RD,1,2021,0,81400,81400,200000,2013-12-03,305000,2009-09-18,0,3700,3700,0,69200,69200,20:17:15,747
913,62 ACORN HILL RD,408/  60/  /  / ,408,60,  , ,175200,175200,0.87,1010,SINGLE FAM MDL01,RD,1,2021,25900,149300,175200,0,,,,26500,100800,127300,26500,100800,127300,20:17:16,748
915,21 POUT POND LN,408/  61/  1000/  / ,408,61,1000,  2306/0650,289500,289500,5.02,1010,SINGLE FAM MDL01,,1,2021,133700,155800,289500,20000,1998-04-02,,,134200,110300,244500,134200,110300,244500,20:17:17,749
916,29 POUT POND LN,408/  61/  2000/  / ,408,61,2000,  3206/0321,349500,349500,5.25,1010,SINGLE FAM MDL01,RD,1,2021,171000,178500,349500,278933,2005-10-13,1,1998-12-09,143400,141200,284600,143400,141200,284600,20:17:19,750
917,53 ACORN HILL RD,408/  62/  /  / ,408,62,  ,  4276/0095,485800,485800,3.8,1090,MULTI HSES,RD,2,2021,250500,235300,485800,389000,2017-04-14,2666,2002-11-07,249900,163200,413100,249900,163200,413100,20:17:20,751
923,115 ACORN HILL RD,408/  66/  /  / ,408,66,  ,  1281/ 272,201400,201400,7.7,1030,MOBILE HOM  MDL-02,RD,2,2021,29900,171500,201400,0,,,,26300,128300,154600,26300,128300,154600,20:17:22,752
924,145 ACORN HILL RD,408/  67/  /  / ,408,67,  ,  4229/0940,6500,477500,67,6516,FARMR-6,RD,1,2021,0,477500,477500,340000,2016-08-26,4000,1996-07-23,0,6500,6500,0,393000,393000,20:17:23,753
925,171 ACORN HILL RD (LAND ONLY),408/  68/  /  / ,408,68,  ,  1281/0272,400,400,0.04,9035,TOWN-PROP,RD,1,2021,0,400,400,0,,,,0,400,400,0,400,400,20:17:23,754
935,114 FRANKLIN HILL RD,408/  70/  2000/  / ,408,70,2000,  4148/0678,721600,721600,5,1090,MULTI HSES,RD,2,2021,458600,263000,721600,670000,2015-08-06,2666,2002-09-25,412900,232400,645300,412900,232400,645300,20:17:24,755
940,84 FRANKLIN HILL RD,408/  71/  2000/  / ,408,71,2000,  3975/ 441,584700,708700,12.1,1010,SINGLE FAM MDL01,RD,1,2021,432600,276100,708700,225000,2013-05-03,110000,2007-10-09,406400,159900,566300,406400,248200,654600,20:17:25,756
941,76 FRANKLIN HILL RD,408/  72/  /  / ,408,72,  ,  4036/0924,566500,566500,0.99,1010,SINGLE FAM MDL01,RD,1,2021,397900,168600,566500,75000,2014-01-21,35000,2002-12-24,361200,163000,524200,361200,163000,524200,20:17:26,757
942,70 FRANKLIN HILL RD,408/  73/  /  / ,408,73,  ,  4664/ 310,630000,630000,2.41,1010,SINGLE FAM MDL01,RD,1,2021,402700,227300,630000,789000,2021-09-01,640000,2015-11-16,377500,222300,599800,377500,222300,599800,20:17:27,758
943,66 FRANKLIN HILL RD,408/  74/  /  / ,408,74,  ,  3618/0895,586100,586100,2.34,1010,SINGLE FAM MDL01,RD,1,2021,324200,261900,586100,500000,2009-06-16,410000,2005-04-07,301800,186200,488000,301800,186200,488000,20:17:28,759
944,56 FRANKLIN HILL RD,408/  75/  1000/  / ,408,75,1000,  4156/0739,651900,733100,21.1,1010,SINGLE FAM MDL01,RD,1,2021,393600,339500,733100,640000,2015-09-08,575000,2009-03-17,309200,227700,536900,309200,313100,622300,20:17:29,760
947,1 FRANKLIN HILL RD,409/  3/  /  / ,409,3,  ,  3781/ 759,478400,478400,3.24,1010,SINGLE FAM MDL01,RD,1,2021,334800,143600,478400,331000,2011-03-17,353533,2009-11-30,311900,93500,405400,311900,93500,405400,20:17:30,761
949,14 FRANKLIN HILL RD,409/  5/  /  / ,409,5,  ,  4520/ 198,584700,770500,112,1010,SINGLE FAM MDL01,RD,1,2021,383600,386900,770500,730000,2020-05-18,285000,1986-05-01,349600,201000,550600,349600,651800,1001400,20:17:31,762
952,147 DORCHESTER RD,409/  8/  /  / ,409,8,  , ,268200,268200,2.36,1010,SINGLE FAM MDL01,RD,1,2021,134400,133800,268200,0,,,,94600,97000,191600,94600,97000,191600,20:17:32,763
953,165 DORCHESTER RD,409/  9/  /  / ,409,9,  ,  2531/0935,310100,310100,0.5,1010,SINGLE FAM MDL01,LCD,1,2021,183800,126300,310100,140000,2001-04-20,128000,1996-09-04,196900,129800,326700,196900,129800,326700,20:17:32,764
1123,179 GOOSE POND RD,410/  60/  /  / ,410,60,  ,   995/0501,177500,177500,21,1030,MOBILE HOM  MDL-02,RD,1,2021,37100,140400,177500,0,,,,14500,115400,129900,14500,115400,129900,20:17:33,765
1125,193 GOOSE POND RD,410/  62/  /  / ,410,62,  ,  1825/0734,77400,77400,0.3,1030,MOBILE HOM  MDL-02,RD,1,2021,27000,50400,77400,49900,1989-09-14,45000,1988-08-15,12200,44600,56800,12200,44600,56800,20:17:34,766
1251,261 DORCHESTER RD,414/  29/  /  / ,414,29,  ,  2044/0116,587400,648000,12,1010,SINGLE FAM MDL01,RD,1,2021,457500,190500,648000,0,1993-08-19,105000,1987-08-12,382500,100300,482800,382500,155000,537500,20:17:35,767
1255,265 DORCHESTER RD,414/  30/  1000/  / ,414,30,1000,  4552/ 717,521300,521300,7.6,1010,SINGLE FAM MDL01,ES,1,2021,363500,157800,521300,550000,2020-09-09,409733,2013-04-15,284600,125300,409900,284600,125300,409900,20:17:36,768
1256,263 DORCHESTER RD,414/  30/  2000/  / ,414,30,2000,  2035/0409,378800,378800,4.41,1010,SINGLE FAM MDL01,RD,1,2021,238500,140300,378800,39000,1993-07-06,4000,1992-09-18,244700,109400,354100,244700,109400,354100,20:17:37,769
1097,12 CLAFLIN LN,410/  34/  /  / ,410,34,  ,4040-0211,900,197900,15,6234,HWUNR-4,RD,1,2021,0,197900,197900,0,2014-02-10,125000,2000-01-28,0,900,900,0,152500,152500,20:17:38,770
983,225 DORCHESTER RD,409/  36/  /  / ,409,36,  ,  3150/0646,149400,149400,5.8,1030,MOBILE HOM  MDL-02,RD,1,2021,12100,137300,149400,50533,2005-06-02,75000,2000-05-08,4600,106700,111300,4600,106700,111300,20:17:39,771
1022,68 ISAAC PERKINS RD,409/  67/  /  / ,409,67,  ,  3277/0647,552800,765700,52,1010,SINGLE FAM MDL01,RD,1,2021,370500,395200,765700,0,2006-04-11,,,256100,140500,396600,256100,333400,589500,20:17:40,772
1038,14 BAKER HILL RD,409/  83/  /  / ,409,83,  ,  4590/ 116,200600,200600,0.47,1010,SINGLE FAM MDL01,RD,1,2021,103600,97000,200600,163900,2020-12-31,42500,1984-01-01,70800,87600,158400,70800,87600,158400,20:17:41,773
1265,343 DORCHESTER RD,414/  34/  /  / ,414,34,  ,  1891/0721,402100,402100,3.1,1010,SINGLE FAM MDL01,,1,2021,255500,146600,402100,110000,1990-12-17,24948,1989-12-15,249900,118100,368000,249900,118100,368000,20:17:42,774
1266,353 DORCHESTER RD,414/  35/  /  / ,414,35,  ,  1344/0648,497400,497400,5.5,1010,SINGLE FAM MDL01,RD,1,2021,324100,173300,497400,57500,1978-06-13,32500,1974-11-08,302300,140100,442400,302300,140100,442400,20:17:43,775
1267,359 DORCHESTER RD,414/  36/  /  / ,414,36,  ,  1779/0679,427400,427400,2.32,1010,SINGLE FAM MDL01,RD,1,2021,278100,149300,427400,30000,1988-12-13,7500,1988-11-17,209900,103700,313600,209900,103700,313600,20:17:43,776
1268,361 DORCHESTER RD,414/  37/  /  / ,414,37,  ,PC-2003,155100,155100,2.2,1030,MOBILE HOM  MDL-02,RD,1,2021,28300,126800,155100,0,2003-01-02,7500,1988-11-17,13000,91900,104900,13000,91900,104900,20:17:44,777
1269,371 DORCHESTER RD,414/  38/  /  / ,414,38,  ,  4492/ 467,321500,417100,22,1010,SINGLE FAM MDL01,RD,1,2021,184700,232400,417100,187500,2020-01-06,,,190400,100000,290400,190400,186900,377300,20:17:45,778
1270,379 DORCHESTER RD (LAND ONLY),414/  39/  /  / ,414,39,  ,  1735/0724,5200,5200,0.54,9035,TOWN-PROP,RD,1,2021,0,5200,5200,187,1988-04-16,,,0,4500,4500,0,4500,4500,20:17:46,779
1271,383 DORCHESTER RD,414/  40/  /  / ,414,40,  ,  4010/0260,463300,463300,4.6,1010,SINGLE FAM MDL01,RD,1,2021,312500,150800,463300,340000,2013-09-09,145000,2010-06-11,321200,111500,432700,321200,111500,432700,20:17:47,780
1272,393 DORCHESTER RD,414/  41/  /  / ,414,41,  ,  4234/0785,520900,738300,76,1010,SINGLE FAM MDL01,RD,1,2021,369200,369100,738300,0,2016-09-19,,,367100,120100,487200,367100,317300,684400,20:17:48,781
1274,401 DORCHESTER RD,414/  43/  /  / ,414,43,  ,  3284/0699,480300,480300,7,1010,SINGLE FAM MDL01,ELD,1,2021,312200,168100,480300,0,2006-05-25,19000,1975-08-15,306100,128300,434400,306100,128300,434400,20:17:49,782
1282,473 DORCHESTER RD,414/  45/  /  / ,414,45,  ,  2121/0393,304600,304600,83,9000,US GOVT,ELD,1,2021,0,304600,304600,0,1994-12-02,,,0,261200,261200,0,261200,261200,20:17:50,783
1291,428 DORCHESTER RD,414/  50/  /  / ,414,50,  ,  3925/0178,400,33700,12.9,6332,OTUNR-2,MFD,1,2021,0,33700,33700,25000,2012-10-18,4000,1981-06-21,0,400,400,0,30600,30600,20:17:50,784
1292,442 DORCHESTER RD,414/  51/  /  / ,414,51,  , ,186800,186800,85,9000,US GOVT,ELD,1,2021,0,186800,186800,0,,,,0,168000,168000,0,168000,168000,20:17:51,785
1299,376 DORCHESTER RD,414/  54/  /  / ,414,54,  ,  2524/0992,453800,453800,0.8,1010,SINGLE FAM MDL01,RD,1,2021,329400,124400,453800,84900,2001-03-14,10000,1997-08-12,312600,93000,405600,312600,93000,405600,20:17:52,786
1250,8 FLINT HILL RD,414/  28/  /  / ,414,28,  ,  2464/0872,447000,447000,3,1010,SINGLE FAM MDL01,RD,1,2021,278300,168700,447000,250000,2000-06-01,220000,1996-09-19,275100,134800,409900,275100,134800,409900,20:17:53,787
1257,267 DORCHESTER RD,414/  31/  /  / ,414,31,  ,  2403/0163,279700,279700,3.1,1010,SINGLE FAM MDL01,RD,1,2021,149000,130700,279700,5000,1999-05-25,105000,1987-08-12,130800,90300,221100,130800,90300,221100,20:17:55,788
1302,320 DORCHESTER RD,414/  57/  /  / ,414,57,  ,  1500/0892,191600,191600,17,9000,US GOVT,RD,1,2021,0,191600,191600,0,,,,0,157900,157900,0,157900,157900,20:17:56,789
1304,39 GRAFTON TK (TAXABLE),414/  58/  1001P/  / ,414,58,  1001P,  0145/0577,1931900,2362900,354.4,3890,SKIWAY,SKIWAY,2,2021,830300,1532600,2362900,0,,,,782300,765000,1547300,782300,1155300,1937600,20:17:57,790
1305,39 GRAFTON TK (NON-TAXABLE),414/  58/  1002P/  / ,414,58,  1002P,  0145/0577,4034300,4034300,82.6,920C,NON PROFIT  MDL-94,SKIWAY,3,2021,3697300,337000,4034300,0,,,,3564000,286000,3850000,3564000,286000,3850000,20:17:58,791
1309,40 GRAFTON TK (TAXABLE),414/  61/  1001P/  / ,414,61,  1001P, ,5200,198000,79.99,6235,HWUNR-5,SKIWAY,1,2021,0,198000,198000,0,,,,0,5200,5200,0,180000,180000,20:17:59,792
1311,40 GRAFTON TK (NON-TAXABLE),414/  61/  1002P/  / ,414,61,  1002P, ,679100,679100,102.8,920C,NON PROFIT  MDL-94,SKIWAY,1,2021,441600,237500,679100,0,,,,411300,215900,627200,411300,215900,627200,20:18:00,793
1312,290 DORCHESTER RD,414/  66/  /  / ,414,66,  ,  1956/0975,778800,778800,590,9000,US GOVT,RD,1,2021,0,778800,778800,318000,1992-03-17,,,0,708000,708000,0,708000,708000,20:18:01,794
1313,274 DORCHESTER RD,414/  62/  /  / ,414,62,  ,  4593/ 892,375600,429700,19.9,1010,SINGLE FAM MDL01,RD,1,2021,241900,187800,429700,0,2021-01-14,143500,1997-08-08,235400,97100,332500,235400,146100,381500,20:18:02,795
1323,254 DORCHESTER RD,414/  64/  /  / ,414,64,  ,  3620/0440,566000,566000,8.6,1010,SINGLE FAM MDL01,RD,1,2021,402700,163300,566000,455000,2009-06-22,190000,1990-10-30,368900,171300,540200,368900,171300,540200,20:18:03,796
1325,22 PONY HILL LN,415/  1/  /  / ,415,1,  ,  1445/0801,459800,459800,5.5,1010,SINGLE FAM MDL01,RD,1,2021,207200,252600,459800,7800,1982-05-26,,,176000,193300,369300,176000,193300,369300,20:18:04,797
1326,55 HARDSCRABBLE LN,415/  2/  /  / ,415,2,  ,  2358/0305,1040900,1183000,22.2,1010,SINGLE FAM MDL01,RD,1,2021,780700,402300,1183000,685000,1998-11-25,4000,1995-09-26,693500,280700,974200,693500,391100,1084600,20:18:05,798
1327,4 TROUT POND LN (TROUT POND,415/  3/  /  / ,415,3,  ,  2108/0373,435200,435200,385.4,9035,TOWN-PROP,MFD,1,2021,0,435200,435200,0,1993-06-30,4000,1990-07-13,0,396800,396800,0,396800,396800,20:18:06,799
1332,46 HARDSCRABBLE LN,415/  8/  /  / ,415,8,  ,  2960/0070,2700,48800,55.5,6232,HWUNR-2,MFD,1,2021,0,48800,48800,10000,2004-02-09,29000,1995-07-21,0,2700,2700,0,44400,44400,20:18:07,800
1333,58 HARDSCRABBLE LN,415/  9/  /  / ,415,9,  ,  2997/0946,751300,857600,23.8,1010,SINGLE FAM MDL01,RD,1,2021,527300,330300,857600,660000,2004-05-13,194000,1995-06-01,417400,217900,635300,417400,314400,731800,20:18:08,801
1336,44 HARDSCRABBLE LN,415/  12/  /  / ,415,12,  ,  3807/0862,7000,259300,145,6133,WPUNR-3,MFD,1,2021,0,259300,259300,250000,2011-07-21,,,0,7000,7000,0,235600,235600,20:18:09,802
1337,43 POUT POND LN,415/  13/  /  / ,415,13,  ,  3123/0868,800,253000,13.61,6234,HWUNR-4,RD,1,2021,0,253000,253000,175000,2005-04-04,40000,1992-03-09,0,800,800,0,188900,188900,20:18:10,803
1375,41 DAVISON LN,416/  12/  /  / ,416,12,  ,  2512/0632,1817600,3300700,700,1010,SINGLE FAM MDL01,RD,1,2021,1454000,1846700,3300700,969000,2001-01-17,2667,2001-01-04,1201400,535400,1736800,1201400,1462100,2663500,20:18:11,804
1235,115 FLINT HILL RD,414/  22/  /  / ,414,22,  ,  2342/0137,235600,235600,0.97,1010,SINGLE FAM MDL01,RD,1,2021,114800,120800,235600,0,1998-09-10,,,71100,91700,162800,71100,91700,162800,20:18:12,805
951,141 DORCHESTER RD,409/  7/  /  / ,409,7,  ,  4108/  22,268200,268200,0.61,1010,SINGLE FAM MDL01,RD,1,2021,161600,106600,268200,60000,2015-01-21,69000,2014-09-02,181500,74700,256200,181500,74700,256200,20:18:13,806
920,75 ACORN HILL RD,408/  64/  1000/  / ,408,64,1000,  2524/0287,668900,735200,16.8,1090,MULTI HSES,RD,2,2021,399600,335600,735200,0,2001-03-21,65000,1985-07-31,360500,215300,575800,360500,275400,635900,20:18:14,807
711,187 ORFORD RD,407/  51/  /  / ,407,51,  ,  2490/0910,288600,288600,2,1010,SINGLE FAM MDL01,RD,2,2021,162700,125900,288600,127000,2000-10-02,,,157400,96300,253700,157400,96300,253700,20:18:15,808
1118,52 PICO RD,410/  55/  /  / ,410,55,  ,  1317/ 217,335100,335100,1.3,1010,SINGLE FAM MDL01,RD,1,2021,204900,130200,335100,16980,1977-06-23,,,195400,93200,288600,195400,93200,288600,20:18:16,809
1119,243 BAKER HILL RD,410/  56/  /  / ,410,56,  ,  3950/0053,3700,290700,46,6233,HWUNR-3,RD,1,2021,0,290700,290700,82500,2013-01-24,212533,2007-10-05,0,3700,3700,0,243100,243100,20:18:17,810
800,100 HIGHBRIDGE RD,407/  110/  /  / ,407,110,  ,  4403/0217,1513900,1562600,13.49,1010,SINGLE FAM MDL01,RD,1,2021,1185500,377100,1562600,1600000,2018-11-26,,,1126900,310300,1437200,1126900,354200,1481100,20:18:18,811
816,15 CUTTING HILL LN,407/  124/  /  / ,407,124,  ,    PC/2003,834000,915200,21.36,1090,MULTI HSES,RD,2,2021,611800,303400,915200,0,2003-02-27,2667,2000-12-19,559700,166600,726300,559700,240100,799800,20:18:18,812
832,10 PINNACLE RD,407/  136/  /  / ,407,136,  ,  2441/0006,100800,100800,0.71,1300,RES ACLNDV,RD,1,2021,0,100800,100800,30600,1999-12-30,,,0,69000,69000,0,69000,69000,20:18:19,813
767,10 WHIPPLE HILL RD,407/  86/  1000/  / ,407,86,1000,  2524/0286,37800,492400,134.7,1060,AC LND IMP,,1,2021,8700,483700,492400,0,2001-03-21,500000,1986-11-18,7400,26600,34000,7400,437800,445200,20:18:20,814
833,100 ORFORD RD,407/  137/  /  / ,407,137,  ,  2525/0653,572400,572400,2.67,1090,MULTI HSES,RD,2,2021,392400,180000,572400,0,2001-03-22,,,287200,122800,410000,287200,122800,410000,20:18:21,815
737,8 TAVERN LN,407/  60/  4000/  / ,407,60,4000,  4570/ 715,1129400,1244000,21.07,1010,SINGLE FAM MDL01,RD,1,2021,854300,389700,1244000,1500000,2020-11-02,95000,1999-05-04,732000,185900,917900,732000,254800,986800,20:18:22,816
739,47 CULVER HILL LN,407/  60/  6000/  / ,407,60,6000,  2692/0805,869900,869900,5.08,1090,MULTI HSES,RD,2,2021,540400,329500,869900,587000,2002-07-24,100000,1999-05-13,409400,265000,674400,409400,265000,674400,20:18:23,817
752,89 WHIPPLE HILL RD,407/  72/  /  / ,407,72,  ,  4459/0802,520600,592300,19.33,1010,SINGLE FAM MDL01,,1,2021,335600,256700,592300,0,2019-08-23,190000,2000-09-28,293500,185500,479000,293500,257900,551400,20:18:24,818
756,115 WHIPPLE HILL RD,407/  76/  3000/  / ,407,76,3000,  2471/0673,657000,911400,80.13,1010,SINGLE FAM MDL01,RD,1,2021,363200,548200,911400,0,2000-06-30,,,350100,251200,601300,350100,482200,832300,20:18:25,819
764,150 WHIPPLE HILL RD,407/  83/  /  / ,407,83,  ,002907/0957,194500,194500,1,1010,SINGLE FAM MDL01,,1,2021,53400,141100,194500,0,2003-10-02,,,55500,84500,140000,55500,84500,140000,20:18:26,820
736,7 TAVERN LN,407/  60/  3000/  / ,407,60,3000,  4614/ 724,1339400,1339400,8.91,1010,SINGLE FAM MDL01,URD,2,2021,1054700,284700,1339400,1435000,2021-03-25,1250000,2006-07-14,977700,289500,1267200,977700,289500,1267200,20:18:27,821
101282,6 ISAAC PERKINS RD,409/  77/  /  / ,409,77,  ,  PRO-/1983,584800,842400,49.6,1010,SINGLE FAM MDL01,RD,1,2021,384200,458200,842400,0,1983-04-16,,,267400,155600,423000,267400,388500,655900,20:18:27,822
101325,310 DARTMOUTH COLLEGE HY,403/  1/  /  / ,403,1,  ,  4633/ 636,832200,1083100,54.32,1010,SINGLE FAM MDL01,RD,1,2021,628800,454300,1083100,0,2021-05-11,100733,2006-05-02,594700,241800,836500,594700,486400,1081100,20:18:28,823
101342,767 RIVER RD,405/  38/  2000/  / ,405,38,2000,  3776/0216,1685700,1787000,5,1013,SFR WATER  MDL-01,RD,1,2021,810900,976100,1787000,2000000,2011-02-18,,,811100,528100,1339200,811100,610500,1421600,20:18:29,824
101362,119 WHIPPLE HILL RD,407/  76/  1000/  / ,407,76,1000,  4442/0404,703300,775800,15.03,1010,SINGLE FAM MDL01,RD,1,2021,516900,258900,775800,167000,2019-07-12,275000,2007-01-04,108200,119700,227900,108200,185500,293700,20:18:30,825
1186,64 TYLER HILL RD,413/  11/  /  / ,413,11,  ,  3848/0046,1200,59000,23,6233,HWUNR-3,MFD,1,2021,0,59000,59000,0,2011-12-30,1330000,2006-09-15,0,1200,1200,0,52600,52600,20:18:31,826
1188,172 GRAFTON TK,413/  14/  /  / ,413,14,  ,  4159/ 809,644100,825700,105,1010,SINGLE FAM MDL01,ELD,1,2021,477000,348700,825700,0,2015-09-18,4000,1978-06-06,464400,130100,594500,464400,294800,759200,20:18:32,827
1189,130 GRAFTON TK,413/  15/  /  / ,413,15,  ,  4408/0421,6800,290400,95,6134,WPUNR-4,ELD,1,2021,0,290400,290400,325000,2018-12-21,,,0,6800,6800,0,242900,242900,20:18:32,828
1190,100 GRAFTON TK,413/  16/  /  / ,413,16,  ,  3780/0740,114300,114300,3.1,1060,AC LND IMP,ELD,1,2021,1200,113100,114300,94000,2011-03-15,30000,1996-03-12,1000,87200,88200,1000,87200,88200,20:18:33,829
1191,96 GRAFTON TK,413/  17/  /  / ,413,17,  ,  3780/0738,110100,110100,2.95,1300,RES ACLNDV,ELD,1,2021,0,110100,110100,94000,2011-03-15,,,0,84500,84500,0,84500,84500,20:18:34,830
1193,25 CANAAN LEDGE LN (L/O),413/  20/  /  / ,413,20,  ,  1302/0550,77500,77500,16,9035,TOWN-PROP,ELD,1,2021,0,77500,77500,0,,,,0,68300,68300,0,68300,68300,20:18:35,831
1195,22 CANAAN LEDGE LN,413/  22/  /  / ,413,22,  ,  3744/0515,474600,474600,7.02,1010,SINGLE FAM MDL01,,1,2021,314400,160200,474600,360000,2010-11-01,265000,1989-06-08,289100,125600,414700,289100,125600,414700,20:18:36,832
1197,14 CANAAN LEDGE LN,413/  24/  /  / ,413,24,  ,  4516/ 908,67900,67900,2,1060,AC LND IMP,,1,2021,4300,63600,67900,525000,2020-04-04,555000,2017-06-28,3900,48900,52800,3900,48900,52800,20:18:38,833
1198,16 CANAAN LEDGE LN,413/  25/  /  / ,413,25,  , ,0,0,0,102V,CONDO NL  MDL-00,ELD,1,2021,0,0,0,0,,,,0,0,0,0,0,0,20:18:39,834
1201,4 CANAAN LEDGE LN,413/  28/  /  / ,413,28,  ,  3692/0952,422600,422600,2,1010,SINGLE FAM MDL01,ELD,1,2021,284500,138100,422600,350000,2010-04-14,72533,2002-10-09,271600,105500,377100,271600,105500,377100,20:18:39,835
1202,2 CANAAN LEDGE LN,413/  29/  /  / ,413,29,  ,  3275/0588,432200,432200,2,1010,SINGLE FAM MDL01,ELD,1,2021,294100,138100,432200,315000,2006-04-28,88000,2001-08-31,308300,105500,413800,308300,105500,413800,20:18:40,836
1203,72 GRAFTON TK,413/  30/  /  / ,413,30,  ,  4112/0911,327200,327200,2,1010,SINGLE FAM MDL01,ELD,1,2021,189100,138100,327200,2667,2015-03-02,,,169000,99800,268800,169000,99800,268800,20:18:41,837
1204,70 GRAFTON TK,413/  31/  /  / ,413,31,  ,  4652/ 369,333100,333100,2,1010,SINGLE FAM MDL01,ELD,1,2021,187600,145500,333100,0,2021-06-23,133333,1993-08-02,223100,105500,328600,223100,105500,328600,20:18:42,838
1206,GRAFTON TK,413/  33/  /  / ,413,33,  ,  2365/0637,625400,625400,556,9000,US GOVT,SD,1,2021,0,625400,625400,205720,1998-12-21,,,0,565200,565200,0,565200,565200,20:18:43,839
1207,5 FLINT HILL RD,414/  1/  /  / ,414,1,  ,  4358/0113,16100,16100,1.1,1320,RES ACLNUD,RD,1,2021,0,16100,16100,0,2018-05-04,50000,1997-01-16,0,12600,12600,0,12600,12600,20:18:44,840
1338,61 POUT POND LN,415/  14/  /  / ,415,14,  ,  4629/ 850,724800,750900,5.28,1010,SINGLE FAM MDL01,RD,1,2021,546500,204400,750900,0,2021-05-06,675000,2012-07-03,518300,155300,673600,518300,174200,692500,20:18:45,841
1342,69 POUT POND LN,415/  17/  /  / ,415,17,  ,  4652/  53,686800,686800,5.28,1010,SINGLE FAM MDL01,RD,1,2021,456000,230800,686800,775000,2021-07-20,675000,2019-12-17,405700,196500,602200,405700,196500,602200,20:18:46,842
1343,73 POUT POND LN,415/  18/  /  / ,415,18,  ,  1972/0070,299200,299200,5.47,1010,SINGLE FAM MDL01,RD,1,2021,100700,198500,299200,0,1991-06-13,70000,1988-01-09,111900,160500,272400,111900,160500,272400,20:18:47,843
1352,82 POUT POND LN,415/  20/  1000/  / ,415,20,1000,  2179/ 517,515700,737500,67.57,1010,SINGLE FAM MDL01,MFD,1,2021,280600,456900,737500,115000,1996-01-29,300000,1986-03-26,248600,244300,492900,248600,450500,699100,20:18:48,844
1353,79 POUT POND LN,415/  20/  2000/  / ,415,20,2000,  2011/0416,972100,1053100,11.08,1010,SINGLE FAM MDL01,RD,1,2021,716800,336300,1053100,115048,1993-02-03,300000,1986-03-26,674200,246700,920900,674200,295200,969400,20:18:49,845
1354,84 POUT POND LN,415/  20/  3000/  / ,415,20,3000,  4999/ 808,673200,751900,9.13,1090,MULTI HSES,RD,2,2021,328100,423800,751900,0,2020-02-10,225048,1993-05-20,390500,244400,634900,390500,315700,706200,20:18:50,846
1355,101 SMITH MOUNTAIN RD,415/  21/  /  / ,415,21,  ,  3867/0316,7500,251200,139,6103,WPM-3,MFD,1,2021,0,251200,251200,141333,2012-03-22,,,0,7500,7500,0,227300,227300,20:18:51,847
1356,141 SMITH MOUNTAIN RD,415/  22/  /  / ,415,22,  ,  2380/0428,59500,2464300,1871.8,6214,HWMR-4,MFD,1,2021,0,2464300,2464300,1125000,1999-03-19,4000,1997-06-02,0,59500,59500,0,2254200,2254200,20:18:52,848
1358,121 TROUT POND LN,415/  24/  /  / ,415,24,  ,  3081/0934,1800,30700,31,6234,HWUNR-4,MFD,1,2021,0,30700,30700,9800,2004-11-30,1000,1957-01-04,0,1800,1800,0,27900,27900,20:18:52,849
1360,200 SMITH MOUNTAIN RD,415/  26/  /  / ,415,26,  ,  3792/0264,12400,228600,117.4,6133,WPUNR-3,MFD,1,2021,0,228600,228600,117000,2011-05-10,5000,1987-04-10,0,12400,12400,0,206800,206800,20:18:53,850
1361,174 SMITH MOUNTAIN RD,415/  27/  /  / ,415,27,  ,   939/ 581,3000,142400,63.7,6232,HWUNR-2,MFD,1,2021,0,142400,142400,0,1960-12-02,,,0,3000,3000,0,128500,128500,20:18:54,851
1362,164 SMITH MOUNTAIN RD,415/  28/  /  / ,415,28,  ,  4159/ 807,14700,96100,130,1320,RES ACLNUD,MFD,1,2021,0,96100,96100,0,2015-09-18,,,0,13300,13300,0,86900,86900,20:18:55,852
1364,66 ORFORDVILLE RD,416/  1/  /  / ,416,1,  ,  4182/  49,1500,221800,18,6225,HWUN-5,RD,1,2021,0,221800,221800,440000,2015-12-23,200000,1997-10-02,0,1500,1500,0,168500,168500,20:18:56,853
1365,58 ORFORDVILLE RD,416/  2/  /  / ,416,2,  ,  4030/0969,200,29900,2.9,6235,HWUNR-5,RD,1,2021,0,29900,29900,0,2013-12-13,30000,2010-05-11,0,200,200,0,22400,22400,20:18:57,854
1366,40 ORFORDVILLE RD,416/  3/  /  / ,416,3,  ,  3477/0857,1600,208500,41,6215,HWMR-5,RD,1,2021,0,208500,208500,150000,2007-12-17,145048,1991-07-18,0,1600,1600,0,184800,184800,20:18:57,855
1367,179 PINNACLE RD,416/  4/  /  / ,416,4,  ,  1924/0324,209600,209600,9.5,1300,RES ACLNDV,RD,1,2021,1900,207700,209600,0,1991-08-16,,,3300,162900,166200,3300,162900,166200,20:18:58,856
1373,226 PINNACLE RD,416/  10/  /  / ,416,10,  ,  4635/ 115,1404700,1599700,44.5,1090,MULTI HSES,RD,2,2021,970800,628900,1599700,0,2021-05-25,190000,1984-12-19,946000,403700,1349700,946000,580800,1526800,20:18:59,857
1171,177 GRAFTON TK,413/  7/  /  / ,413,7,  ,  2508/0665,1200,83700,14.3,6225,HWUN-5,ELD,1,2021,0,83700,83700,25000,2000-12-19,18500,1987-02-27,0,1200,1200,0,65400,65400,20:19:00,858
1374,15 DAVISON LN,416/  11/  /  / ,416,11,  ,  4124/0466,496700,496700,9.35,1010,SINGLE FAM MDL01,RD,1,2021,271300,225400,496700,0,2015-04-24,65000,1975-06-06,181700,207800,389500,181700,207800,389500,20:19:01,859
1379,30 DAVISON LN,416/  14/  /  / ,416,14,  ,  1783/0870,4300,144500,65.7,6235,HWUNR-5,,1,2021,0,144500,144500,7722,1988-12-30,,,0,4300,4300,0,131400,131400,20:19:02,860
1382,16 DAVISON LN,416/  16/  /  / ,416,16,  ,  4383/0408,958600,958600,3.6,1010,SINGLE FAM MDL01,,1,2021,613200,345400,958600,880000,2018-08-22,330000,1989-10-18,495200,390700,885900,495200,390700,885900,20:19:03,861
1187,194 GRAFTON TK,413/  13/  /  / ,413,13,  ,  2490/0597,500,72300,6.3,6225,HWUN-5,ELD,1,2021,0,72300,72300,27533,2000-09-29,1,1981-06-05,0,500,500,0,55000,55000,20:19:04,862
1384,196 PINNACLE RD,416/  18/  /  / ,416,18,  ,  3478/0839,860400,1223800,58.9,1010,SINGLE FAM MDL01,RD,1,2021,633900,589900,1223800,0,2007-12-21,,,514900,340200,855100,514900,553900,1068800,20:19:05,863
1385,192 PINNACLE RD,416/  19/  /  / ,416,19,  , 04357/0060,768500,878900,10.51,1010,SINGLE FAM MDL01,RD,1,2021,596200,282700,878900,837500,2018-04-30,4000,1994-12-09,468200,224500,692700,468200,313500,781700,20:19:06,864
1386,25 PONY HILL LN,416/  20/  /  / ,416,20,  ,002951/0697,1206700,1530600,48,1010,SINGLE FAM MDL01,RD,1,2021,800900,729700,1530600,800000,2004-01-23,,,843000,392100,1235100,843000,684800,1527800,20:19:06,865
1388,3 TROUT POND LN,416/  22/  /  / ,416,22,  ,PRO-2012,8200,264000,135,6222,HWUN-2,MFD,1,2021,0,264000,264000,0,2012-06-08,3000,1966-03-01,0,8200,8200,0,234700,234700,20:19:07,866
1389,36 PONY HILL LN,416/  23/  /  / ,416,23,  ,  1295/0448,336800,365700,15,1010,SINGLE FAM MDL01,RD,1,2021,159400,206300,365700,0,,,,111500,141900,253400,111500,179500,291000,20:19:08,867
1394,100 DAVISON LN,416/  24/  /  / ,416,24,  ,  2299/0262,11800,166300,378,6213,HWMR-3,,1,2021,0,166300,166300,0,1998-02-24,20000,1996-02-02,0,11800,11800,0,151200,151200,20:19:09,868
1399,281 SMITH MOUNTAIN RD,416/  25/  /  / ,416,25,  ,  3081/0934,3600,61600,70,6233,HWUNR-3,MFD,1,2021,0,61600,61600,9800,2004-11-30,,,0,3600,3600,0,56000,56000,20:19:10,869
1400,180 CELLARS LN,416/  26/  /  / ,416,26,  ,  3081/0934,6300,93700,131,6232,HWUNR-2,MFD,1,2021,0,93700,93700,9800,2004-11-30,,,0,6300,6300,0,85200,85200,20:19:11,870
1401,190 CELLARS LN,416/  27/  /  / ,416,27,  ,  3759/0935,3300,49300,56,6323,OTUN-3,MFD,1,2021,0,49300,49300,2086533,2010-12-17,,,0,3300,3300,0,44800,44800,20:19:11,871
1402,115 ORFORDVILLE RD,417/  1/  /  / ,417,1,  ,  2621/0721,4000,305600,30.1,6325,OTUN-5,RD,1,2021,0,305600,305600,150000,2002-01-07,65048,1992-03-25,0,4000,4000,0,220100,220100,20:19:12,872
1403,137 ORFORDVILLE RD,417/  2/  /  / ,417,2,  ,  3231/0774,100,8500,3.1,6810,WETLANDS-REC,RD,1,2021,0,8500,8500,0,2005-12-12,144000,1994-11-19,0,100,100,0,7800,7800,20:19:13,873
1410,120 ORFORDVILLE RD,417/  6/  1000/  / ,417,6,1000,  1920/0238,274600,358200,11.15,1010,SINGLE FAM MDL01,RD,1,2021,165400,192800,358200,55048,1991-07-18,,,153800,114800,268600,153800,184100,337900,20:19:14,874
1412,124 CELLARS LN,417/  7/  /  / ,417,7,  ,  4157/  66,202900,311900,25,1010,SINGLE FAM MDL01,MFD,1,2021,105000,206900,311900,0,2015-09-09,4000,1974-02-25,96200,75900,172100,96200,174600,270800,20:19:15,875
1413,395 SMITH MOUNTIAN RD,418/  1/  /  / ,418,1,  ,  2008/0656,2100,86600,35,6221,HWUN-1,MFD,1,2021,0,86600,86600,4000,1992-12-28,,,0,2100,2100,0,78800,78800,20:19:16,876
1417,370 SMITH MOUNTAIN RD,418/  3/  /  / ,418,3,  ,  1411/0301,16700,345400,314,6234,HWUNR-4,MFD,1,2021,0,345400,345400,60000,1980-12-02,,,0,16700,16700,0,374000,374000,20:19:17,877
101204, WHIPPLE HILL RD,407/  86/  6000/  / ,407,86,6000,  2524/0286,2800,206800,7.61,6506,FARM-6,RD,1,2021,0,206800,206800,0,2001-03-21,500000,1986-11-18,0,2800,2800,0,161000,161000,20:19:17,878
101205, WHIPPLE HILL RD,407/  86/  7000/  / ,407,86,7000,  2524/0286,2500,213100,7.5,6126,WPUN-6,RD,1,2021,0,213100,213100,0,2001-03-21,500000,1986-11-18,0,2500,2500,0,159500,159500,20:19:18,879
101262,46 POUT POND LN,414/  65/  /  / ,414,65,  ,  4541/ 909,591300,649200,12.14,1010,SINGLE FAM MDL01,RD,1,2021,405400,243800,649200,702000,2020-08-03,13500,2000-07-20,380700,163700,544400,380700,216300,597000,20:19:19,880
101203, WHIPPLE HILL RD,407/  86/  5000/  / ,407,86,5000,  2524/0286,6400,244300,15.1,6506,FARM-6,RD,1,2021,0,244300,244300,0,2001-03-21,500000,1986-11-18,0,6400,6400,0,195100,195100,20:19:21,881
100822,605 RIVER RD,405/  26/  /  / ,405,26,  ,  3561/0702,437800,781500,22,1013,SFR WATER  MDL-01,RD,1,2021,147600,633900,781500,817533,2008-10-31,,,134100,265300,399400,134100,557300,691400,20:19:22,882
102854,158 GOOSE POND RD,401/  31/  2000/  / ,401,31,2000,  4274/0187,158700,158700,1.04,1010,SINGLE FAM MDL01,RD,1,2021,67300,91400,158700,0,2017-03-23,,,45900,69600,115500,45900,69600,115500,20:19:23,883
100863,161 GOOSE POND RD,401/  23/  1200/  / ,401,23,1200,  2966/0694,267300,267300,3.44,1010,SINGLE FAM MDL01,,1,2021,162900,104400,267300,0,2004-02-29,25000,1999-06-18,154900,81500,236400,154900,81500,236400,20:19:24,884
101082,10 WHIPPLE HILL RD-GRAVELPIT,407/  86/  1100/  / ,407,86,1100,  2524/0286,179500,179500,4.27,4430,GRAVEL PIT,RD,1,2021,0,179500,179500,0,2001-03-21,,,0,135200,135200,0,135200,135200,20:19:25,885
101143,53 SMITH MOUNTAIN RD,414/  15/  /  / ,414,15,  ,  2491/0503,796000,884500,24.5,1010,SINGLE FAM MDL01,,1,2021,588800,295700,884500,0,2000-09-06,,,503500,142500,646000,503500,222700,726200,20:19:26,886
100582,85 DARTMOUTH COLLEGE HY #9030,401/  55/  903/  / ,401,55,903,  4284/0022,385200,385200,0,1021,CONDO NL  MDL-05,BD,1,2021,385200,0,385200,0,2017-05-15,310000,2009-05-20,346100,0,346100,346100,0,346100,20:19:27,887
100622,81 BRECK HILL RD,405/  3/  /  / ,405,3,  ,  2468/0135,1500,54500,8.26,6126,WPUN-6,RD,1,2021,0,54500,54500,280000,2000-05-09,6000,1988-08-13,0,1500,1500,0,49600,49600,20:19:28,888
100142,85 DARTMOUTH COLLEGE HY #1010,401/  55/  101/  / ,401,55,101,  4263/0860,217500,217500,0,1021,CONDO NL  MDL-05,BD,1,2021,217500,0,217500,0,2017-01-25,179933,2003-02-27,185200,0,185200,185200,0,185200,20:19:29,889
100162,85 DARTMOUTH COLLEGE HY #1020,401/  55/  102/  / ,401,55,102,  3704/0320,217500,217500,0,1021,CONDO NL  MDL-05,BD,1,2021,217500,0,217500,192000,2010-05-13,215000,2005-05-19,185200,0,185200,185200,0,185200,20:19:30,890
100163,85 DARTMOUTH COLLEGE HY #1030,401/  55/  103/  / ,401,55,103,  4220/0349,251600,251600,0,1021,CONDO NL  MDL-05,BD,1,2021,251600,0,251600,235000,2016-07-18,230000,2003-10-15,229300,0,229300,229300,0,229300,20:19:30,891
100164,85 DARTMOUTH COLLEGE HY #1050,401/  55/  105/  / ,401,55,105,  4210/0461,244700,244700,0,1021,CONDO NL  MDL-05,BD,1,2021,244700,0,244700,225000,2016-05-31,245000,2007-06-12,213500,0,213500,213500,0,213500,20:19:31,892
100243,82 NORTH THETFORD RD,407/  53/  4000/  / ,407,53,4000,PRO315-2010,637100,708100,11.18,1010,SINGLE FAM MDL01,RD,1,2021,478200,229900,708100,0,2012-02-01,650000,2005-07-12,388000,131300,519300,388000,194600,582600,20:19:32,893
100282,205 ORFORD RD,407/  53/  3000/  / ,407,53,3000,  4211/0344,736000,736000,8.7,1010,SINGLE FAM MDL01,RD,1,2021,545900,190100,736000,591500,2016-06-07,60000,1999-09-23,447700,161300,609000,447700,161300,609000,20:19:33,894
100462,85 DARTMOUTH COLLEGE HY #2030,401/  55/  203/  / ,401,55,203,  4299/0751,204700,204700,0,1021,CONDO NL  MDL-05,,1,2021,204700,0,204700,195000,2017-07-24,189000,2010-05-13,188700,0,188700,188700,0,188700,20:19:34,895
100000,106 PRESTON RD,402/  18/  1000/  / ,402,18,1000,  3944/0114,933100,1006700,15.33,1010,SINGLE FAM MDL01,RD,1,2021,765900,240800,1006700,0,2012-12-28,160000,2004-01-20,681800,174100,855900,681800,237700,919500,20:19:35,896
636,131 MUD TURTLE POND RD,406/  33/  /  / ,406,33,  ,  2060/0453,4200,4200,1.1,1320,RES ACLNUD,RD,1,2021,0,4200,4200,1111,1993-11-12,154,1993-05-10,0,3300,3300,0,3300,3300,20:19:36,897
100322,117 BRECK HILL RD,405/  7/  /  / ,405,7,  ,2160-0298,4300,77200,14.78,6514,FARMR-4,RD,1,2021,0,77200,77200,565000,1995-09-20,4000,1989-07-24,0,4300,4300,0,70300,70300,20:19:37,898
1019,41 ISAAC PERKINS RD,409/  64/  /  / ,409,64,  ,  1830/  26,428300,428300,3.2,1010,SINGLE FAM MDL01,RD,1,2021,265300,163000,428300,37263,1989-10-26,,,253200,126000,379200,253200,126000,379200,20:19:37,899
1101,59 PICO RD,410/  38/  /  / ,410,38,  ,  4449/0260,303900,303900,2.07,1010,SINGLE FAM MDL01,RD,1,2021,176500,127400,303900,320000,2019-07-10,262733,2006-07-28,157500,86200,243700,157500,86200,243700,20:19:38,900
1124,183 GOOSE POND RD,410/  61/  /  / ,410,61,  ,  1393/ 175,134500,134500,1.9,1030,MOBILE HOM  MDL-02,RD,1,2021,39500,95000,134500,0,,,,120300,68900,189200,120300,68900,189200,20:19:39,901
101243,32 POUT POND LN,409/  23/  1000/  / ,409,23,1000,002703/0615,842500,842500,7.67,1010,SINGLE FAM MDL01,RD,1,2021,621200,221300,842500,99000,2002-08-22,,,486400,188500,674900,486400,188500,674900,20:19:40,902
100182,85 DARTMOUTH COLLEGE HY #1040,401/  55/  104/  / ,401,55,104,  4666/ 182,377100,377100,0,1021,CONDO NL  MDL-05,,1,2021,377100,0,377100,390000,2021-09-01,345000,2019-07-16,326100,0,326100,326100,0,326100,20:19:41,903
1192,17 CANAAN LEDGE LN (L/O),413/  19/  /  / ,413,19,  , ,22300,22300,2.7,9035,TOWN-PROP,ELD,1,2021,0,22300,22300,0,,,,0,18100,18100,0,18100,18100,20:19:42,904
102,3 MAIN ST,201/  71/  /  / ,201,71,  , ,111500,111500,0.63,9010,STATE NH,LCD,1,2021,7500,104000,111500,0,,,,7500,91900,99400,7500,91900,99400,20:19:43,905
138,1 DORCHESTER RD,201/  95/  /  / ,201,95,  ,  1005/ 574,1440500,1440500,0.33,906I,CHURCH ETC  MDL-96,LCD,1,2021,1194500,246000,1440500,0,,,,1092000,237600,1329600,1092000,237600,1329600,20:19:46,906
231,162 GOOSE POND RD,401/  31/  1000/  / ,401,31,1000,   PC-/1985,174100,174100,1.03,1010,SINGLE FAM MDL01,RD,1,2021,82800,91300,174100,0,1985-09-12,,,57100,69500,126600,57100,69500,126600,20:19:47,907
101582, DORCHESTER RD,414/  48/  /  / ,414,48,  ,,2800,118800,54,6233,HWUNR-3,,1,2021,0,118800,118800,0,,,,0,2800,2800,0,108000,108000,20:19:48,908
274,20 WILMOTT WY,401/  64/  /  / ,401,64,  ,  2107/0953,369700,369700,6,1010,SINGLE FAM MDL01,RD,1,2021,230700,139000,369700,110000,1994-08-31,,,197900,101700,299600,197900,101700,299600,20:19:48,909
100642,60 BRECK HILL RD,405/  49/  /  / ,405,49,  ,  2468/0135,33000,33000,5,1320,RES ACLNUD,RD,1,2021,0,33000,33000,280000,2000-05-09,,,0,30000,30000,0,30000,30000,20:19:51,910
537,125 BRECK HILL RD,405/  8/  /  / ,405,8,  ,  4464/0381,856200,856200,4.06,1010,SINGLE FAM MDL01,RD,1,2021,544100,312100,856200,900000,2019-09-11,230900,1996-10-07,601700,274900,876600,601700,274900,876600,20:19:54,911
649,45 POST POND LN,407/  10/  /  / ,407,10,  ,  2039/0056,573400,573400,0.42,1013,SFR WATER  MDL-01,,1,2021,318500,254900,573400,357524,1993-07-23,115053,1990-02-20,282700,268400,551100,282700,268400,551100,20:19:54,912
720,216 ORFORD RD,407/  56/  1000/  / ,407,56,1000,  4488/ 947,388200,388200,5.04,1010,SINGLE FAM MDL01,RD,1,2021,213000,175200,388200,359000,2019-12-18,290000,2014-06-25,153400,137000,290400,153400,137000,290400,20:19:55,913
311,92 PRESTON RD,402/  19/  /  / ,402,19,  ,  3718/0951,15600,637800,146.1,6235,HWUNR-5,RD,1,2021,0,637800,637800,494000,2010-07-07,233760,1986-12-30,0,15600,15600,0,537000,537000,20:19:56,914
234,148 GOOSE POND RD,401/  34/  /  / ,401,34,  ,  4038/0683,362900,362900,1.9,1010,SINGLE FAM MDL01,RD,1,2021,228500,134400,362900,290000,2014-01-31,45000,2004-04-06,234500,78100,312600,234500,78100,312600,20:19:57,915
238,104 GOOSE POND RD,401/  38/  /  / ,401,38,  ,  4166/ 733,282400,282400,2.6,1010,SINGLE FAM MDL01,RD,1,2021,149100,133300,282400,0,2015-10-15,155000,2013-05-01,108100,93500,201600,108100,93500,201600,20:19:59,916
243,54 GOOSE POND RD,401/  40/  /  / ,401,40,  ,  4586/ 837,900,9700,1.1,1300,RES ACLNDV,RD,1,2021,0,9700,9700,1845000,2020-12-21,315000,2009-07-22,0,900,900,0,8800,8800,20:20:00,917
277,62 RIVER RD,401/  67/  /  / ,401,67,  ,  4102/0216,1500,58200,4.4,6516,FARMR-6,RD,1,2021,0,58200,58200,550000,2014-12-19,300000,2007-11-20,0,1500,1500,0,48300,48300,20:20:01,918
291,85 RIVER RD,401/  78/  /  / ,401,78,  ,  4102/0216,6400,139200,20,6515,FARMR-5,RD,1,2021,0,139200,139200,550000,2014-12-19,,,0,6400,6400,0,117400,117400,20:20:01,919
303,23 WASHBURN HILL RD,402/  11/  /  / ,402,11,  ,  3835/0890,571300,571300,7.9,1040,TWO FAMILY,RD,2,2021,392100,179200,571300,0,2011-11-16,20650,1999-12-18,310800,142900,453700,310800,142900,453700,20:20:02,920
317,71 PRESTON RD,402/  25/  /  / ,402,25,  ,  2411/0774,514700,514700,2,1010,SINGLE FAM MDL01,,1,2021,361800,152900,514700,289500,1999-08-06,155000,1989-08-21,361600,127700,489300,361600,127700,489300,20:20:04,921
122,32 PLEASANT ST,201/  85/  /  / ,201,85,  ,  4599/ 918,406300,406300,0.7,1010,SINGLE FAM MDL01,LCD,1,2021,273000,133300,406300,0,2021-02-23,375000,2005-01-28,223700,105800,329500,223700,105800,329500,20:20:05,922
124,26+28 PLEASANT ST,201/  87/  /  / ,201,87,  ,  4171/ 903,577900,577900,1,1050,THREE FAM,LCD,2,2021,354900,223000,577900,455000,2015-11-17,,,326200,140700,466900,326200,140700,466900,20:20:06,923
142,11 DORCHESTER RD,201/  99/  /  / ,201,99,  ,  4466/0210,393700,393700,1.71,1010,SINGLE FAM MDL01,LCD,1,2021,183800,209900,393700,365000,2019-09-19,350000,2007-12-18,190500,184600,375100,190500,184600,375100,20:20:07,924
152,38 HIGH ST,201/  105/  /  / ,201,105,  ,  2446/0833,260000,260000,0.22,1010,SINGLE FAM MDL01,LCD,1,2021,175200,84800,260000,0,2000-02-15,4000,1960-08-08,130800,70400,201200,130800,70400,201200,20:20:08,925
169,12 CREAMERY LN,201/  119/  /  / ,201,119,  ,  4210/0547,265300,265300,0.61,1010,SINGLE FAM MDL01,LCD,1,2021,154200,111100,265300,0,2016-06-03,90000,2013-12-10,130800,92200,223000,130800,92200,223000,20:20:08,926
180,19 ROCKY HILL LN,201/  130/  /  / ,201,130,  ,  3840/0869,812100,882500,18.7,1010,SINGLE FAM MDL01,,1,2021,597800,284700,882500,0,2011-12-06,653000,2011-07-19,557700,225900,783600,557700,289900,847600,20:20:09,927
201,114 DARTMOUTH COLLEGE HY,401/  13/  1000/  / ,401,13,1000,  4596/  46,457500,574400,29.93,1010,SINGLE FAM MDL01,RD,1,2021,322700,251700,574400,580000,2021-01-21,501200,2008-09-30,350000,101500,451500,350000,229300,579300,20:20:10,928
202,20 PRESTON RD,401/  13/  2000/  / ,401,13,2000,  2400/0641,685600,1166800,112.33,1010,SINGLE FAM MDL01,RD,1,2021,392300,774500,1166800,0,1999-05-12,320000,1995-12-28,377800,227900,605700,377800,664500,1042300,20:20:11,929
100122,378 DORCHESTER RD,414/  55/  /  / ,414,55,  ,  4246/0965,546700,667300,30,1010,SINGLE FAM MDL01,R,1,2021,386900,280400,667300,0,2016-10-09,115000,2000-07-17,316200,125500,441700,316200,234500,550700,20:20:12,930
55,6 ON THE COMMON UNIT #6,201/  35/  0060/  / ,201,35,60,  2558/0753,195600,195600,0,1021,CONDO NL  MDL-05,CD,1,2021,195600,0,195600,2666,2001-06-21,94500,2000-06-29,151200,0,151200,151200,0,151200,20:20:13,931
57,2 ON THE COMMON,201/  37/  /  / ,201,37,  ,  4472/0485,964700,964700,1.4,1010,SINGLE FAM MDL01,LCD,1,2021,734700,230000,964700,985000,2019-10-10,275000,2003-01-10,714200,202400,916600,714200,202400,916600,20:20:13,932
62,30 UNION ST,201/  42/  /  / ,201,42,  ,  2469/0823,649200,649200,0.46,1010,SINGLE FAM MDL01,LCD,2,2021,485300,163900,649200,174000,2000-06-23,,,404000,172100,576100,404000,172100,576100,20:20:15,933
65,24 UNION ST,201/  45/  /  / ,201,45,  ,  4164/ 281,544900,544900,1.1,1010,SINGLE FAM MDL01,LCD,1,2021,316000,228900,544900,0,2015-10-01,460000,2013-04-26,288100,201400,489500,288100,201400,489500,20:20:16,934
67,20 UNION ST (BIG ROCK),201/  47/  /  / ,201,47,  ,  3059/0499,103200,103200,12.82,9200,NON PROFIT  MDL-00,LCD,1,2021,0,103200,103200,0,2004-09-29,475000,2001-05-29,0,87400,87400,0,87400,87400,20:20:17,935
77,13 UNION ST,201/  51/  2000/  / ,201,51,2000,  3831/0623,578400,578400,2.07,1010,SINGLE FAM MDL01,LCD,1,2021,343500,234900,578400,501000,2011-11-01,308500,2002-01-12,338100,206800,544900,338100,206800,544900,20:20:18,936
88,1 HAMILTON LN,201/  62/  /  / ,201,62,  ,  2467/0958,156600,156600,0.26,1010,SINGLE FAM MDL01,LCD,1,2021,43200,113400,156600,0,2000-06-15,55000,1994-04-12,36900,75200,112100,36900,75200,112100,20:20:19,937
95,2 EAST THETFORD RD,201/  69/  /  / ,201,69,  ,  2501/0649,617700,617700,0.72,1040,TWO FAMILY,,1,2021,410100,207600,617700,280000,2000-11-21,140000,1993-02-03,287100,189100,476200,287100,189100,476200,20:20:20,938
117,25 PLEASANT ST,201/  80/  0010/  / ,201,80,10,  3470/0508,426300,426300,0,102R,CONDO NL  MDL-01,LCD,2,2021,426300,0,426300,390000,2007-11-27,295000,2003-09-03,388500,0,388500,388500,0,388500,20:20:21,939
29,14 MARKET ST,201/  22/  /  / ,201,22,  ,  4339/0611,656100,656100,3.91,1010,SINGLE FAM MDL01,LCD,1,2021,420400,235700,656100,2666,2018-01-23,294000,2000-10-02,393200,207900,601100,393200,207900,601100,20:20:23,940
30,10 MARKET ST,201/  23/  /  / ,201,23,  ,  3959/0892,494000,494000,1.38,1010,SINGLE FAM MDL01,LCD,1,2021,275800,218200,494000,278533,2013-03-04,,,273700,161800,435500,273700,161800,435500,20:20:24,941
33,6 MARKET ST,201/  26/  /  / ,201,26,  ,  4368/0297,328000,328000,0.29,1010,SINGLE FAM MDL01,LCD,1,2021,176400,151600,328000,0,2018-06-19,329067,2014-06-25,148000,153900,301900,148000,153900,301900,20:20:25,942
921,77 ACORN HILL RD,408/  64/  2000/  / ,408,64,2000,  2446/0463,507600,551500,12.12,1090,MULTI HSES,,2,2021,302400,249100,551500,0,2000-02-10,65000,1985-07-31,267600,128800,396400,267600,168600,436200,20:20:26,943
934,108 FRANKLIN HILL RD,408/  70/  1000/  / ,408,70,1000,  2503/0991,1200,222900,15.7,6115,WPMR-5,R,1,2021,0,222900,222900,2667,2000-11-30,47000,1996-09-04,0,1200,1200,0,174700,174700,20:20:27,944
939,96 FRANKLIN HILL RD,408/  71/  1000/  / ,408,71,1000,  2503/0992,841300,1036700,47.12,1010,SINGLE FAM MDL01,RD,3,2021,596300,440400,1036700,2667,2000-11-30,585000,1995-09-13,518000,293400,811400,518000,472700,990700,20:20:27,945
962,179 DORCHESTER RD,409/  15/  /  / ,409,15,  ,  4313/0720,484300,484300,0.42,1010,SINGLE FAM MDL01,LCD,1,2021,371900,112400,484300,460000,2017-09-25,392533,2013-06-17,311100,118200,429300,311100,118200,429300,20:20:28,946
969,45 ACORN HILL RD,409/  22/  /  / ,409,22,  ,  3470/0235,299400,299400,4.4,1010,SINGLE FAM MDL01,RD,1,2021,143300,156100,299400,0,2007-11-26,85000,1996-08-30,118900,103800,222700,118900,103800,222700,20:20:29,947
977,8 ACORN HILL RD,409/  30/  /  / ,409,30,  ,  4298/0327,776700,776700,5,1010,SINGLE FAM MDL01,RD,1,2021,584200,192500,776700,732000,2017-07-17,715000,2015-06-24,565300,152800,718100,565300,152800,718100,20:20:30,948
899,21 HARDSCRABBLE LN,408/  54/  /  / ,408,54,  ,  4334/0863,1004700,1253900,30.3,1010,SINGLE FAM MDL01,RD,1,2021,738600,515300,1253900,1200000,2017-12-28,900000,1999-09-08,604100,267900,872000,604100,468800,1072900,20:20:31,949
875,43 FRANKLIN HILL RD,408/  37/  /  / ,408,37,  ,  4638/ 858,663100,663100,3.65,1010,SINGLE FAM MDL01,RD,1,2021,434800,228300,663100,0,2021-06-02,143000,2000-05-01,411400,201500,612900,411400,201500,612900,20:20:32,950
877,73 FRANKLIN HILL RD,408/  39/  /  / ,408,39,  ,  4414/0452,784200,871700,11.34,1010,SINGLE FAM MDL01,RD,1,2021,468400,403300,871700,795000,2019-01-31,545000,1999-12-13,401000,322800,723800,401000,402000,803000,20:20:33,951
881,56 HORTON LN,408/  43/  /  / ,408,43,  ,  2510/0926,1558300,1640300,20,1010,SINGLE FAM MDL01,RD,1,2021,1268800,371500,1640300,485000,2001-01-12,80000,1980-12-15,990200,361200,1351400,990200,435700,1425900,20:20:33,952
895,181 ACORN HILL RD,408/  50/  /  / ,408,50,  ,  3891/0463,941900,1026500,11.65,1010,SINGLE FAM MDL01,RD,1,2021,743700,282800,1026500,0,2012-06-15,765000,2006-06-28,574400,192900,767300,574400,269500,843900,20:20:34,953
896,11 HIGHBRIDGE RD,408/  51/  /  / ,408,51,  ,  2470/0120,1387300,1470000,14.9,1010,SINGLE FAM MDL01,RD,1,2021,1117300,352700,1470000,960000,2000-06-24,190000,1992-02-10,885800,307400,1193200,885800,382200,1268000,20:20:35,954
898,11 HARDSCRABBLE LN,408/  53/  /  / ,408,53,  ,  4335/0100,1200,425300,13.5,6226,HWUN-6,RD,1,2021,0,425300,425300,375000,2017-12-29,900000,1999-09-08,0,1200,1200,0,316200,316200,20:20:36,955
839,39 PLEASANT ST,408/  2/  /  / ,408,2,  ,  4584/ 724,714600,900500,41.97,1010,SINGLE FAM MDL01,LCD,1,2021,534600,365900,900500,0,2020-12-14,800000,2018-06-15,470800,139800,610600,470800,303000,773800,20:20:37,956
768,150 ORFORD RD,407/  87/  /  / ,407,87,  ,  2495/0263,843700,843700,2.2,3400,OFFICE BLD  MDL-94,RD,1,2021,627900,215800,843700,0,2000-10-23,,,464000,168200,632200,464000,168200,632200,20:20:38,957
771,1 PINNACLE RD,407/  90/  /  / ,407,90,  ,  3464/0860,488900,488900,5.4,101,Single Fam,RD,1,2021,283000,205900,488900,360000,2007-11-02,265000,2002-08-13,216300,160700,377000,216300,160700,377000,20:20:39,958
785,65 PINNACLE RD,407/  97/  /  / ,407,97,  ,  3866/0622,1171200,1408400,69,1010,SINGLE FAM MDL01,RD,2,2021,857100,551300,1408400,0,2012-03-20,675000,2001-12-14,701000,398200,1099200,701000,613600,1314600,20:20:39,959
799,112 HIGHBRIDGE RD,407/  109/  /  / ,407,109,  ,  3926/0840,558800,558800,5.1,1010,SINGLE FAM MDL01,RD,1,2021,375900,182900,558800,0,2012-10-24,555000,2007-10-15,363200,161600,524800,363200,161600,524800,20:20:40,960
27,22 MARKET ST,201/  20/  /  / ,201,20,  ,  3701/0145,536700,536700,2.08,1010,SINGLE FAM MDL01,LCD,1,2021,326700,210000,536700,0,2010-05-17,437533,2008-08-21,325200,184600,509800,325200,184600,509800,20:20:41,961
36,18 ON THE COMMON,201/  29/  /  / ,201,29,  ,  4469/0248,719200,719200,2.2,3400,OFFICE BLD  MDL-94,LCD,1,2021,303000,416200,719200,775000,2019-09-30,950000,2007-05-01,404700,318600,723300,404700,318600,723300,20:20:42,962
51,6 ON THE COMMON UNIT #2,201/  35/  0020/  / ,201,35,20,  4659/ 112,197400,197400,0,1021,CONDO NL  MDL-05,LCD,1,2021,197400,0,197400,216000,2021-08-06,107133,2012-02-07,144300,0,144300,144300,0,144300,20:20:43,963
52,6 ON THE COMMON UNIT #3,201/  35/  0030/  / ,201,35,30,  3943/0473,184100,184100,0,1021,CONDO NL  MDL-05,LCD,1,2021,184100,0,184100,150000,2012-12-27,132000,2005-02-14,141100,0,141100,141100,0,141100,20:20:44,964
53,6 ON THE COMMON UNIT #4,201/  35/  0040/  / ,201,35,40,  4220/0472,208500,208500,0,1021,CONDO NL  MDL-05,LCD,1,2021,208500,0,208500,176000,2016-07-14,140000,2013-07-30,162700,0,162700,162700,0,162700,20:20:44,965
1387,50 PONY HILL LN,416/  21/  /  / ,416,21,  ,  4339/0351,2800,356000,31,6234,HWUNR-4,RD,1,2021,0,356000,356000,0,2018-01-22,120000,1999-06-29,0,2800,2800,0,283500,283500,20:20:45,966
1406,128 ORFORDVILLE RD,417/  5/  /  / ,417,5,  ,  2495/0444,933700,1388500,77.6,1010,SINGLE FAM MDL01,RD,1,2021,703700,684800,1388500,200000,2000-10-24,150000,1992-03-25,754700,274500,1029200,754700,546800,1301500,20:20:46,967
1462,622 DORCHESTER RD,420/  22/  /  / ,420,22,  ,  4638/ 462,592900,755800,73.67,1010,SINGLE FAM MDL01,ELD,1,2021,316800,439000,755800,0,2021-05-03,449000,2000-05-01,280900,216200,497100,280900,362400,643300,20:20:47,968
1298,420 DORCHESTER RD,414/  53/  /  / ,414,53,  ,  4350/0600,1180800,1317900,29.24,1010,SINGLE FAM MDL01,ELD,1,2021,1009200,308700,1317900,1300000,2018-03-29,535000,2003-08-14,900600,225200,1125800,900600,349700,1250300,20:20:48,969
1319,266 DORCHESTER RD,414/  63/  /  / ,414,63,  ,  4204/0599,23200,199400,20,1060,AC LND IMP,RD,1,2021,5700,193700,199400,0,2016-05-12,455000,2009-06-22,3900,20900,24800,3900,159300,163200,20:20:49,970
1335,34 HARDSCRABBLE LN,415/  11/  /  / ,415,11,  ,  2416/0844,562600,562600,20,1010,SINGLE FAM MDL01,RD,1,2021,307900,254700,562600,249000,1999-05-07,95000,1988-09-14,309700,243500,553200,309700,243500,553200,20:20:50,971
1340,65 POUT POND LN,415/  15/  /  / ,415,15,  ,  4488/ 166,420500,420500,5.02,1080,SFR/ACC UNIT,RD,1,2021,225000,195500,420500,399000,2019-12-16,325000,2000-07-11,306100,194900,501000,306100,194900,501000,20:20:51,972
1341,67 POUT POND LN,415/  16/  /  / ,415,16,  ,  4427/0561,847300,847300,6.11,1080,SFR/ACC UNIT,RD,1,2021,644800,202500,847300,0,2019-04-18,550000,2000-04-15,540800,231100,771900,540800,231100,771900,20:20:52,973
1344,75+77 POUT POND LN,415/  19/  /  / ,415,19,  ,  4048/0440,796700,1620100,298.1,1010,SINGLE FAM MDL01,RD,1,2021,518400,1101700,1620100,1462533,2014-04-04,4000,1992-06-23,503200,271000,774200,503200,733300,1236500,20:20:53,974
1263,307 DORCHESTER RD,414/  32/  /  / ,414,32,  ,  4232/0263,326500,565000,37.5,1010,SINGLE FAM MDL01,RD,1,2021,156000,409000,565000,0,2016-09-06,,,156600,129000,285600,156600,345300,501900,20:20:53,975
787,67+69 PINNACLE RD,407/  99/  /  / ,407,99,  ,  1830/ 743,405300,405300,0.7,1090,MULTI HSES,RD,2,2021,238800,166500,405300,95053,1989-10-31,,,247800,95100,342900,247800,95100,342900,20:20:54,976
963,181 DORCHESTER RD,409/  16/  /  / ,409,16,  ,  3876/0956,484900,484900,0.59,3400,OFFICE BLD  MDL-94,LCD,1,2021,245600,239300,484900,325000,2012-04-27,,,261400,167800,429200,261400,167800,429200,20:20:55,977
1058,294 BAKER HILL RD,410/  3/  /  / ,410,3,  ,  4519/ 343,26400,280200,26,1060,AC LND IMP,RD,1,2021,9400,270800,280200,396933,2020-05-14,,,8900,12400,21300,8900,213800,222700,20:20:56,978
1277,443 DORCHESTER RD,414/  44/  /  / ,414,44,  ,  4193/0233,13900,294200,149,6334,OTUNR-4,ELD,1,2021,0,294200,294200,50000,2016-03-15,,,0,13900,13900,0,261000,261000,20:20:57,979
1363,461 DORCHESTER RD,415/  29/  /  / ,415,29,  ,  3850/0766,8500,89400,112,1320,RES ACLNUD,MFD,1,2021,0,89400,89400,75000,2011-12-29,,,0,7600,7600,0,80700,80700,20:20:58,980
1448,615 DORCHESTER RD,420/  8/  /  / ,420,8,  ,  2105/0870,183000,282000,15.1,1300,RES ACLNDV,ELD,1,2021,0,282000,282000,4000,1994-08-20,160000,1990-01-26,0,142000,142000,0,241500,241500,20:20:58,981
100264,80 NORTH THETFORD RD,404/  51/  /  / ,404,51,  ,  3700/0068,400,208200,11.46,6334,OTUNR-4,RD,1,2021,0,208200,208200,0,2010-04-12,125000,2002-10-08,0,400,400,0,185900,185900,20:20:59,982
100583,95 DARTMOUTH COLLEGE HY #1234,401/  55/  123/  / ,401,55,123,  2327/0460,1848200,1848200,0,904C,PRI SCHOOL  MDL-94,BD,4,2021,1848200,0,1848200,750000,1998-07-08,,,1690400,0,1690400,1690400,0,1690400,20:21:00,983
103117,15  MAIN ST,201/  77/  T/  / ,201,77,  T,  4157/0986,81500,81500,0.14,310,PRI COMM,LCD,1,2021,37000,44500,81500,553000,2015-09-17,,,39700,44500,84200,39700,44500,84200,20:21:01,984
101162,15 MAIN ST,201/  77/  E/  / ,201,77,  E,  4157/0986,526400,526400,0.8,912,HISTORICAL/APT,LCD,1,2021,273300,253100,526400,553000,2015-09-17,525000,2010-05-12,234200,253100,487300,234200,253100,487300,20:21:02,985
1070,168 BAKER HILL RD,410/  11/  /  / ,410,11,  ,  3718/0518,231900,231900,9.2,1030,MOBILE HOM  MDL-02,RD,1,2021,62100,169800,231900,0,2010-07-06,,,48800,134300,183100,48800,134300,183100,20:21:03,986
103178,BAKER HILL RD,410/  13/  1200/  / ,410,13,1200,  4303/ 340,121600,121600,0.19,903I,MUNICPAL  MDL-96,RD,1,2021,33600,88000,121600,0,2017-08-08,,,48800,134300,183100,48800,134300,183100,20:21:03,987
1077,44 BAILEY HILL LN,410/  33/  2000/  / ,410,33,2000,  3848/0046,30700,997900,525,6234,HWUNR-4,RD,1,2021,0,997900,997900,0,2011-12-30,1330000,2006-09-15,0,30700,30700,0,909100,909100,20:21:04,988
1078,99 BEAR HILL LN,410/  15/  /  / ,410,15,  ,  4008/0854,304800,304800,6.2,1010,SINGLE FAM MDL01,RD,1,2021,200900,103900,304800,289000,2013-09-04,170000,2003-05-08,166600,82200,248800,166600,82200,248800,20:21:05,989
1081,103 BEAR HILL LN,410/  18/  /  / ,410,18,  ,  3869/0217,100,92100,0.94,6133,WPUNR-3,RD,1,2021,0,92100,92100,0,2012-03-15,65000,2007-11-16,0,100,100,0,63500,63500,20:21:06,990
1082,107 BEAR HILL LN,410/  19/  /  / ,410,19,  ,  3380/0854,129600,129600,0.91,1010,SINGLE FAM MDL01,RD,1,2021,33700,95900,129600,0,2007-02-15,5000,1987-12-07,49500,72100,121600,49500,72100,121600,20:21:07,991
1083,111 BEAR HILL LN,410/  20/  /  / ,410,20,  ,  3869/0217,3900,572000,116,6333,OTUNR-3,RD,1,2021,0,572000,572000,0,2012-03-15,350000,2005-02-18,0,3900,3900,0,491600,491600,20:21:08,992
1084,102 BEAR HILL LN,410/  21/  /  / ,410,21,  ,  3869/0217,100,33700,0.63,6133,WPUNR-3,RD,1,2021,0,33700,33700,0,2012-03-15,36000,2008-01-04,0,100,100,0,23200,23200,20:21:09,993
1085,38 BAILEY HILL LN,410/  22/  /  / ,410,22,  ,  3869/0214,1300,140400,13.28,6124,WPUN-4,RD,1,2021,0,140400,140400,0,2012-03-21,,,0,1300,1300,0,108100,108100,20:21:10,994
1087,24 BAILEY HILL LN,410/  24/  /  / ,410,24,  ,  3657/0390,83500,83500,8,1300,RES ACLNDV,RD,1,2021,0,83500,83500,0,2009-10-27,60000,2004-09-02,0,68100,68100,0,68100,68100,20:21:11,995
1091,205 BAKER HILL RD,410/  28/  /  / ,410,28,  ,  1245/ 349,234400,234400,1.93,1010,SINGLE FAM MDL01,RD,1,2021,89200,145200,234400,0,1975-03-18,,,76500,99500,176000,76500,99500,176000,20:21:12,996
1092,215 BAKER HILL RD,410/  29/  /  / ,410,29,  ,  2354/0060,470800,470800,4.06,1010,SINGLE FAM MDL01,RD,1,2021,309500,161300,470800,168000,1998-11-06,149000,1997-07-01,308900,125600,434500,308900,125600,434500,20:21:13,997
1093,7 CLAFLIN LN,410/  30/  /  / ,410,30,  ,  4179/ 709,139200,139200,7.89,1300,RES ACLNDV,RD,1,2021,0,139200,139200,52000,2015-12-17,73000,1980-04-07,0,113400,113400,0,113400,113400,20:21:13,998
1094,15 CLAFLIN LN,410/  31/  /  / ,410,31,  ,  4612/ 260,420500,420500,17.7,1010,SINGLE FAM MDL01,RD,1,2021,179900,240600,420500,405000,2021-03-17,,,161200,186300,347500,161200,186300,347500,20:21:14,999
1096,42 CLAFLIN LN,410/  33/  1000/  / ,410,33,1000,  4557/ 709,1862900,2324500,77.52,1090,MULTI HSES,RD,3,2021,1543900,780600,2324500,2575000,2020-09-24,1550000,2009-10-05,1186300,299800,1486100,1186300,632300,1818600,20:21:15,1000
1098,25 PICO RD,410/  35/  /  / ,410,35,  ,  4040/0208,1800,227800,26,6236,HWUNR-6,RD,1,2021,0,227800,227800,0,2014-02-10,27000,1999-02-12,0,1800,1800,0,184200,184200,20:21:16,1001
1102,65 PICO RD,410/  39/  /  / ,410,39,  ,  3550/0554,229000,229000,2.44,1010,SINGLE FAM MDL01,RD,1,2021,94200,134800,229000,180000,2008-09-15,,,79300,92900,172200,79300,92900,172200,20:21:17,1002
1104,7 BLISS LN,410/  41/  /  / ,410,41,  ,  4328/0018,724900,969700,40.83,1010,SINGLE FAM MDL01,RD,1,2021,535000,434700,969700,0,2017-11-29,795000,2014-02-10,527000,156600,683600,527000,372600,899600,20:21:18,1003
1105,31 BLISS LN,410/  42/  /  / ,410,42,  ,  3497/0389,725500,970800,42,1010,SINGLE FAM MDL01,RD,1,2021,538000,432800,970800,810000,2008-03-06,4000,1988-08-19,498600,165900,664500,498600,382200,880800,20:21:18,1004
692,13 NORTH THETFORD RD,407/  32/  /  / ,407,32,  ,  2495/0042,806000,806000,3.72,1090,MULTI HSES,RD,2,2021,578500,227500,806000,500000,2000-10-29,8500,1988-06-24,516900,151300,668200,516900,151300,668200,20:21:19,1005
1109,74 BLISS LN,410/  46/  1000/  / ,410,46,1000,  4046/0956,868500,1143300,54.35,1010,SINGLE FAM MDL01,RD,2,2021,653900,489400,1143300,1695000,2014-03-27,1025000,2012-06-04,600500,209100,809600,600500,458600,1059100,20:21:20,1006
694,17 NORTH THETFORD RD,407/  34/  /  / ,407,34,  ,  3793/0253,343200,343200,2.03,1010,SINGLE FAM MDL01,RD,1,2021,191000,152200,343200,245000,2011-05-17,113000,1998-06-30,163000,114700,277700,163000,114700,277700,20:21:21,1007
1111,60 BLISS LN,410/  48/  /  / ,410,48,  ,  1327/0271,128800,128800,2.9,1300,RES ACLNDV,RD,1,2021,0,128800,128800,0,,,,0,103700,103700,0,103700,103700,20:21:22,1008
1112,54 BLISS LN,410/  49/  /  / ,410,49,  ,  1677/ 894,365300,365300,3,1010,SINGLE FAM MDL01,RD,1,2021,196600,168700,365300,4000,1981-07-02,,,161500,134800,296300,161500,134800,296300,20:21:23,1009
1113,50 BLISS LN,410/  50/  /  / ,410,50,  ,   PRO/2000,296000,528800,70.9,1030,MOBILE HOM  MDL-02,RD,1,2021,73200,455600,528800,0,2000-10-02,,,46300,178700,225000,46300,389600,435900,20:21:24,1010
695,21 NORTH THETFORD RD,407/  35/  /  / ,407,35,  ,002784/0570,373100,373100,7.97,1010,SINGLE FAM MDL01,RD,1,2021,179300,193800,373100,0,2003-02-27,147000,1999-08-11,138900,157700,296600,138900,157700,296600,20:21:25,1011
706,30 NORTH THETFORD RD,407/  46/  /  / ,407,46,  ,  2482/0411,410100,410100,4.9,1010,SINGLE FAM MDL01,RD,1,2021,213600,196500,410100,189000,2000-08-22,165000,1994-08-08,202400,158400,360800,202400,158400,360800,20:21:26,1012
960,175 DORCHESTER RD,409/  13/  /  / ,409,13,  ,  1990/0036,324700,324700,0.43,101,Single Fam,LCD,1,2021,209600,115100,324700,100000,1992-09-23,,,196300,111100,307400,196300,111100,307400,20:21:26,1013
961,177 DORCHESTER RD,409/  14/  /  / ,409,14,  ,  0880/0574,627600,627600,2.8,906I,CHURCH ETC  MDL-96,LCD,2,2021,383800,243800,627600,0,,,,349400,201300,550700,349400,201300,550700,20:21:27,1014
964,15 DERBY LN,409/  17/  /  / ,409,17,  ,  4501/ 324,211200,211200,4.1,1300,RES ACLNDV,LCD,1,2021,0,211200,211200,218700,2020-02-18,,,79100,153500,232600,79100,153500,232600,20:21:28,1015
965,183 DORCHESTER RD (LCAB),409/  18/  /  / ,409,18,  , ,755500,755500,1.3,903C,MUNICPAL  MDL-94,LCD,1,2021,524400,231100,755500,0,,,,459700,188600,648300,459700,188600,648300,20:21:29,1016
1121,305 BAKER HILL RD,410/  58/  /  / ,410,58,  ,  1880/0011,369900,369900,1.1,1010,SINGLE FAM MDL01,RD,1,2021,221000,148900,369900,10000,1990-09-14,,,195500,102800,298300,195500,102800,298300,20:21:30,1017
1122,171 GOOSE POND RD,410/  59/  /  / ,410,59,  ,PRO-2013,125100,125100,2.9,1030,MOBILE HOM  MDL-02,RD,1,2021,27800,97300,125100,0,2013-12-17,1500,1976-05-24,10300,67100,77400,10300,67100,77400,20:21:30,1018
773,21 PINNACLE RD,407/  92/  /  / ,407,92,  ,  4166/ 137,142900,142900,6.7,1300,RES ACLNDV,RD,1,2021,0,142900,142900,0,2015-10-20,,,0,107300,107300,0,107300,107300,20:21:31,1019
774,31 PINNACLE RD,407/  93/  /  / ,407,93,  ,  4020/0964,308900,308900,2,1010,SINGLE FAM MDL01,RD,1,2021,161200,147700,308900,1,2013-10-24,,,125900,107500,233400,125900,107500,233400,20:21:32,1020
775,33 PINNACLE RD,407/  94/  /  / ,407,94,  ,  1619/0305,292100,292100,5.3,1010,SINGLE FAM MDL01,RD,1,2021,127300,164800,292100,0,1986-09-03,,,91900,123000,214900,91900,123000,214900,20:21:33,1021
776,35 PINNACLE RD,407/  95/  /  / ,407,95,  ,  4622/ 621,610900,610900,4.1,1010,SINGLE FAM MDL01,RD,1,2021,404000,206900,610900,700000,2021-04-19,,,370200,131400,501600,370200,131400,501600,20:21:34,1022
102956,DARTMOUTH COLLEGE HY,401/  53/  2000/  / ,401,53,2000,  4013/ 0515,237100,237100,25,1300,RES ACLNDV,RD,1,2021,0,237100,237100,233400,2013-09-23,,,0,206300,206300,0,206300,206300,20:21:35,1023
1208,17 FLINT HILL RD,414/  2/  /  / ,414,2,  ,  4344/0915,456500,456500,2.1,1010,SINGLE FAM MDL01,RD,1,2021,293700,162800,456500,0,2018-02-23,308000,1996-12-30,288100,141600,429700,288100,141600,429700,20:21:35,1024
1209,21 FLINT HILL RD,414/  3/  /  / ,414,3,  ,  4140/0820,493600,493600,9,1010,SINGLE FAM MDL01,RD,1,2021,294100,199500,493600,448000,2015-07-06,4000,1999-02-16,278000,156700,434700,278000,156700,434700,20:21:36,1025
1211,35 POUT POND LN,414/  5/  /  / ,414,5,  ,  3046/0042,284000,284000,5.03,1010,SINGLE FAM MDL01,RD,1,2021,116300,167700,284000,182000,2004-08-25,88600,1990-09-19,112900,120000,232900,112900,120000,232900,20:21:37,1026
1212,39 POUT POND LN,414/  6/  /  / ,414,6,  ,  3316/0974,660800,660800,6.4,1010,SINGLE FAM MDL01,RD,1,2021,470800,190000,660800,140000,2006-08-15,119000,2005-06-01,369200,160700,529900,369200,160700,529900,20:21:38,1027
1213,45 POUT POND LN,414/  7/  /  / ,414,7,  ,  4207/0517,579700,579700,3.46,1010,SINGLE FAM MDL01,,1,2021,390400,189300,579700,565000,2016-05-20,541000,2012-07-31,393500,160800,554300,393500,160800,554300,20:21:39,1028
1215,60 POUT POND LN,414/  9/  1000/  / ,414,9,1000,  1963/0583,5000,419900,41.9,6134,WPUNR-4,RD,1,2021,0,419900,419900,1,1991-12-04,,,0,5000,5000,0,331500,331500,20:21:40,1029
1222,75 FLINT HILL RD,414/  11/  1100/  / ,414,11,1100,  4110/0719,572400,644900,12.8,1010,SINGLE FAM MDL01,RD,3,2021,376600,268300,644900,0,2015-02-13,425000,2009-02-20,316000,155300,471300,316000,221100,537100,20:21:41,1030
1223,63 FLINT HILL RD,414/  11/  1200/  / ,414,11,1200,  3669/0147,7600,428700,90.4,6135,WPUNR-5,RD,1,2021,0,428700,428700,400000,2009-12-16,215000,1998-11-25,0,7600,7600,0,403400,403400,20:21:42,1031
1225,91 FLINT HILL RD,414/  12/  /  / ,414,12,  ,  1964/ 126,394400,441400,12.4,1010,SINGLE FAM MDL01,RD,1,2021,222900,218500,441400,0,1992-04-30,4000,1988-06-07,215800,147900,363700,215800,190500,406300,20:21:43,1032
1226,80 POUT POND LN,414/  13/  /  / ,414,13,  ,  3669/0171,1289500,1545600,43.7,1010,SINGLE FAM MDL01,,1,2021,831300,714300,1545600,900000,2009-12-16,115000,1994-05-09,828300,475500,1303800,828300,617400,1445700,20:21:44,1033
1227,39 SMITH MOUNTAIN RD,414/  14/  /  / ,414,14,  ,  4085/ 718,574300,785600,65,1010,SINGLE FAM MDL01,MFD,1,2021,425300,360300,785600,785000,2014-10-01,55000,1988-04-28,404100,146300,550400,404100,338100,742200,20:21:45,1034
1228,55 SMITH MOUNTAIN RD,415/  30/  /  / ,415,30,  ,  3638/0924,330800,506600,70.1,1010,SINGLE FAM MDL01,RD,1,2021,162200,344400,506600,0,2009-08-17,4000,1994-04-08,139600,144500,284100,139600,303900,443500,20:21:45,1035
1230,30 SMITH MOUNTAIN RD,414/  17/  /  / ,414,17,  ,  4111/0830,493300,637200,39,1010,SINGLE FAM MDL01,RD,1,2021,358200,279000,637200,0,2015-02-23,,,302600,103300,405900,302600,233900,536500,20:21:46,1036
1232,12 SMITH MOUNTAIN RD,414/  19/  /  / ,414,19,  ,  2031/0905,303600,303600,3.2,1010,SINGLE FAM MDL01,RD,1,2021,156500,147100,303600,0,1993-06-16,,,157000,113400,270400,157000,113400,270400,20:21:47,1037
1233,99 FLINT HILL RD,414/  20/  /  / ,414,20,  ,  4112/0072,480900,480900,4.2,1010,SINGLE FAM MDL01,RD,1,2021,304300,176600,480900,0,2015-02-25,,,277100,166400,443500,277100,166400,443500,20:21:48,1038
1234,107 FLINT HILL RD,414/  21/  /  / ,414,21,  ,  1480/0843,266100,266100,1.26,1010,SINGLE FAM MDL01,RD,1,2021,129400,136700,266100,0,1983-08-21,,,100400,93900,194300,100400,93900,194300,20:21:49,1039
1236,119 FLINT HILL RD,414/  23/  /  / ,414,23,  ,  2080/0748,209700,209700,8.9,1010,SINGLE FAM MDL01,RD,1,2021,66500,143200,209700,0,,,,51800,106900,158700,51800,106900,158700,20:21:50,1040
1247,74 FLINT HILL RD,414/  26/  1000/  / ,414,26,1000,  3804/0023,792700,926800,23.6,1010,SINGLE FAM MDL01,RD,1,2021,510900,415900,926800,779000,2011-07-05,350000,1995-03-21,426000,236900,662900,426000,358400,784400,20:21:50,1041
1248,66 FLINT HILL RD,414/  26/  2000/  / ,414,26,2000,  1464/0667,691300,775400,14.8,1080,SFR/ACC UNIT,RD,1,2021,455900,319500,775400,0,,,,431100,217500,648600,431100,293900,725000,20:21:51,1042
1249,44 FLINT HILL RD,414/  27/  /  / ,414,27,  ,  1488/ 345,590700,590700,36.9,906R,CHURCH ETC  MDL-01,RD,1,2021,176600,414100,590700,0,,,,161600,375100,536700,161600,375100,536700,20:21:52,1043
101382,117 WHIPPLE HILL RD,407/  76/  2000/  / ,407,76,2000,002805/0119,426600,473200,13.31,1010,SINGLE FAM MDL01,RD,1,2021,244400,228800,473200,0,2003-04-04,,,246400,182700,429100,246400,225000,471400,20:21:53,1044
89,7 HAMILTON LN,201/  63/  /  / ,201,63,  ,  1749/0748,491800,627900,57,1010,SINGLE FAM MDL01,LCD,1,2021,252300,375600,627900,142000,1988-06-27,117000,1986-12-15,272500,211800,484300,272500,334800,607300,20:21:54,1045
224,12 PELTON LN,401/  28/  /  / ,401,28,  ,  3039/0757,449600,449600,5.97,1010,SINGLE FAM MDL01,RD,1,2021,234300,215300,449600,305000,2004-08-17,23300,1996-12-09,222000,167900,389900,222000,167900,389900,20:21:55,1046
272,30 WILMOTT WY (LAND ONLY),401/  62/  /  / ,401,62,  , ,11300,11300,1.3,9035,TOWN-PROP,RD,1,2021,0,11300,11300,0,,,,0,9000,9000,0,9000,9000,20:21:56,1047
401,187 RIVER RD,402/  103/  /  / ,402,103,  , ,1188900,1188900,44,9010,STATE NH,RD,1,2021,0,1188900,1188900,0,,,,0,1058500,1058500,0,1058500,1058500,20:21:56,1048
518,120 NORTH THETFORD RD,404/  43/  /  / ,404,43,  ,  4593/  46,508600,508600,7.1,1010,SINGLE FAM MDL01,RD,1,2021,290800,217800,508600,525000,2021-01-12,420000,2011-03-14,275100,177700,452800,275100,177700,452800,20:21:57,1049
1289,370 DORCHESTER RD,414/  49/  /  / ,414,49,  ,  3846/0171,2600,181900,88.17,6212,HWMR-2,RD,1,2021,0,181900,181900,88000,2011-12-22,,,0,2600,2600,0,165300,165300,20:21:58,1050
100103,188 GOOSE POND RD,410/  72/  /  / ,410,72,  ,  3667/0146,345800,463900,19.5,1010,SINGLE FAM MDL01,RD,1,2021,234700,229200,463900,0,2009-12-02,170000,1993-05-20,243600,84100,327700,243600,190700,434300,20:21:59,1051
103036,216 RIVER RD,402/  75/  /  / ,402,75,  ,  2998/ 599,2000,369500,47.8,6335,OTUNR-5,RD,1,2021,0,369500,369500,0,2004-05-06,,,0,2000,2000,0,302800,302800,20:22:00,1052
103016,375 RIVER RD,403/  27/  /  / ,403,27,  ,  3206/0303,77600,334700,58.1,1060,AC LND IMP,RD,1,2021,34800,299900,334700,0,2005-01-01,,,34200,43200,77400,34200,263800,298000,20:22:03,1053
103079,ORFORD RD,406/  16/  /  / ,406,16,  ,  1734/0766,2300,218500,60,6334,OTUNR-4,RD,1,2021,0,218500,218500,4000,1988-04-25,,,0,2300,2300,0,203700,203700,20:22:04,1054
103078,341 ORFORD RD,406/  4/  /  / ,406,4,  ,  1734/0766,90200,154400,25.06,1300,RES ACLNDV,RD,1,2021,11500,142900,154400,4000,1988-04-25,,,11200,78900,90100,11200,137000,148200,20:22:05,1055
103097,ORFORD RD,406/  4/  1/  / ,406,4,1,  4341/0411,3000,49900,31.56,6124,WPUN-4,,1,2021,0,49900,49900,100000,2018-02-01,,,0,3000,3000,0,45700,45700,20:22:06,1056
103157,399  ORFORD RD,406/  9/  /  / ,406,9,  ,  4144/0076,4500,218000,14,6515,FARMR-5,,1,2021,0,218000,218000,0,2015-07-10,,,0,4500,4500,0,210000,210000,20:22:07,1057
102996,117 BAKER HILL RD,409/  59/  /  / ,409,59,  ,4068-0370,9900,443800,108,6234,HWUNR-4,RD,1,2021,0,443800,443800,350000,2014-07-03,,,0,9900,9900,0,378400,378400,20:22:08,1058